stem	register	gloss	notes	semantic_family	role_group	primary_section	structural_class
a	REGISTER_A						
a	REGISTER_B						
ache	REGISTER_B						
acthed	REGISTER_B						
ad	REGISTER_B						
adar	REGISTER_B						
adche	REGISTER_B						
aekeee	REGISTER_B						
aes	REGISTER_B						
ag	REGISTER_B						
ai	REGISTER_B						
aick	REGISTER_B						
aifh	REGISTER_B						
aifhh	REGISTER_B						
aiid	REGISTER_B						
aiiikhed	REGISTER_B						
aiiin	REGISTER_A						
aiiin	REGISTER_B						
aiiinro	REGISTER_B						
aiik	REGISTER_B						
aiim	REGISTER_A						
aiim	REGISTER_B						
aiin	REGISTER_A		family=F_PROC_CORE;role_group=PROC;primary_section=Recipes;struct=CL_PROC_MIXED	F_PROC_CORE	PROC	Recipes	CL_PROC_MIXED
aiin	REGISTER_B		family=F_PROC_CORE;role_group=PROC;primary_section=Recipes;struct=CL_PROC_MIXED	F_PROC_CORE	PROC	Recipes	CL_PROC_MIXED
aiin	UNKNOWN		family=F_PROC_CORE;role_group=PROC;primary_section=Recipes;struct=CL_PROC_MIXED	F_PROC_CORE	PROC	Recipes	CL_PROC_MIXED
aiinog	REGISTER_B						
aiip	REGISTER_B						
aiir	REGISTER_A						
aiir	REGISTER_B						
aiiral	REGISTER_B						
aiis	REGISTER_A						
aiis	REGISTER_B						
aiisaim	REGISTER_B						
aiisod	REGISTER_B						
aikh	REGISTER_B						
aikhd	REGISTER_B						
ail	REGISTER_B						
aild	REGISTER_B						
aim	REGISTER_A						
aim	REGISTER_B						
ain	REGISTER_A		family=F_PROC_CORE;role_group=PROC;primary_section=Recipes;struct=CL_PROC_MIXED	F_PROC_CORE	PROC	Recipes	CL_PROC_MIXED
ain	REGISTER_B		family=F_PROC_CORE;role_group=PROC;primary_section=Recipes;struct=CL_PROC_MIXED	F_PROC_CORE	PROC	Recipes	CL_PROC_MIXED
ainarals	REGISTER_B						
aindar	REGISTER_B						
aiph	REGISTER_B						
aiphe	REGISTER_B						
aiphhe	REGISTER_B						
air	REGISTER_A		family=F_PROC_CORE;role_group=PROC;primary_section=Recipes;struct=CL_PROC_MIXED	F_PROC_CORE	PROC	Recipes	CL_PROC_MIXED
air	REGISTER_B		family=F_PROC_CORE;role_group=PROC;primary_section=Recipes;struct=CL_PROC_MIXED	F_PROC_CORE	PROC	Recipes	CL_PROC_MIXED
airald	REGISTER_B						
airar	REGISTER_A						
airch	REGISTER_A						
airo	REGISTER_B						
airod	REGISTER_B						
airorlch	REGISTER_B						
ais	REGISTER_B						
aith	REGISTER_A						
aith	REGISTER_B						
aithchr	REGISTER_B						
ak	REGISTER_B						
akaiik	REGISTER_B						
akar	REGISTER_B						
akarar	REGISTER_B						
akch	REGISTER_B						
akched	REGISTER_B						
ake	REGISTER_B						
al	REGISTER_A		family=F_PROC_CORE;role_group=PROC;primary_section=Recipes;struct=CL_PROC_MIXED	F_PROC_CORE	PROC	Recipes	CL_PROC_MIXED
al	REGISTER_B		family=F_PROC_CORE;role_group=PROC;primary_section=Recipes;struct=CL_PROC_MIXED	F_PROC_CORE	PROC	Recipes	CL_PROC_MIXED
al	UNKNOWN		family=F_PROC_CORE;role_group=PROC;primary_section=Recipes;struct=CL_PROC_MIXED	F_PROC_CORE	PROC	Recipes	CL_PROC_MIXED
alaiiin	REGISTER_B						
alair	REGISTER_B						
alaird	REGISTER_A						
alal	REGISTER_B						
alald	REGISTER_B						
alamch	REGISTER_A						
alar	REGISTER_B						
alcfh	REGISTER_A						
alch	REGISTER_A						
alch	REGISTER_B						
alchd	REGISTER_B						
alche	REGISTER_A						
alche	REGISTER_B						
alched	REGISTER_B						
alchek	REGISTER_B						
alches	REGISTER_B						
alchk	REGISTER_B						
alchl	REGISTER_B						
ald	REGISTER_A						
ald	REGISTER_B						
ald	UNKNOWN						
aldalos	REGISTER_B						
aldar	REGISTER_B						
aleed	REGISTER_B						
alekee	REGISTER_A						
alf	REGISTER_B						
alfo	REGISTER_B						
alfshed	REGISTER_B						
alg	REGISTER_A						
alg	REGISTER_B						
alk	REGISTER_B						
alkair	REGISTER_B						
alkar	REGISTER_B						
alkchd	REGISTER_B						
alke	REGISTER_B						
alked	REGISTER_A						
alked	REGISTER_B						
alkee	REGISTER_B						
alkeear	REGISTER_B						
alkeed	REGISTER_B						
all	REGISTER_B						
allke	REGISTER_B						
alo	REGISTER_B						
alod	REGISTER_B						
alodar	REGISTER_B						
aloees	REGISTER_A						
aloees	REGISTER_B						
alog	REGISTER_B						
aloiiin	REGISTER_B						
aloiin	REGISTER_B						
alol	REGISTER_B						
alold	REGISTER_B						
alolfch	REGISTER_B						
alols	REGISTER_B						
alolshed	REGISTER_B						
alom	REGISTER_B						
alor	REGISTER_B						
alos	REGISTER_B						
alpchd	REGISTER_B						
alpchdar	REGISTER_B						
als	REGISTER_A						
als	REGISTER_B						
alsh	REGISTER_B						
alshe	REGISTER_B						
alshed	REGISTER_B						
alte	REGISTER_B						
alys	REGISTER_A						
alys	REGISTER_B						
am	REGISTER_A		family=F_PROC_CORE;role_group=PROC;primary_section=Recipes;struct=CL_PROC_MIXED	F_PROC_CORE	PROC	Recipes	CL_PROC_MIXED
am	REGISTER_B		family=F_PROC_CORE;role_group=PROC;primary_section=Recipes;struct=CL_PROC_MIXED	F_PROC_CORE	PROC	Recipes	CL_PROC_MIXED
amch	REGISTER_B						
amchd	REGISTER_B						
amd	REGISTER_B						
amg	REGISTER_A						
amg	REGISTER_B						
amod	REGISTER_B						
amom	REGISTER_B						
an	REGISTER_A						
an	REGISTER_B						
an	UNKNOWN						
ap	REGISTER_B						
aporair	REGISTER_B						
ar	REGISTER_A		family=F_PROC_CORE;role_group=PROC;primary_section=Recipes;struct=CL_PROC_MIXED	F_PROC_CORE	PROC	Recipes	CL_PROC_MIXED
ar	REGISTER_B		family=F_PROC_CORE;role_group=PROC;primary_section=Recipes;struct=CL_PROC_MIXED	F_PROC_CORE	PROC	Recipes	CL_PROC_MIXED
arair	REGISTER_B						
arairal	REGISTER_B						
aral	REGISTER_A						
aralar	REGISTER_B						
arald	REGISTER_B						
aralos	REGISTER_B						
arals	REGISTER_B						
arar	REGISTER_A						
arar	REGISTER_B						
araro	REGISTER_B						
arayd	REGISTER_B						
arch	REGISTER_B						
archee	REGISTER_A						
are	REGISTER_A						
arg	REGISTER_A						
ariin	REGISTER_B						
arl	REGISTER_A						
arl	REGISTER_B						
aro	REGISTER_B						
arod	REGISTER_A						
arod	REGISTER_B						
arodaim	REGISTER_B						
arodched	REGISTER_A						
arodl	REGISTER_B						
aroiin	REGISTER_B						
aroka	REGISTER_B						
arolk	REGISTER_B						
arolsas	REGISTER_A						
arorshee	REGISTER_B						
aros	REGISTER_A						
arosh	REGISTER_B						
arote	REGISTER_B						
arotee	REGISTER_B						
arsheg	REGISTER_B						
arx	REGISTER_B						
aryl	REGISTER_A						
as	REGISTER_A						
as	REGISTER_B						
asa	REGISTER_A						
asal	REGISTER_B						
ash	REGISTER_B						
at	REGISTER_A						
at	REGISTER_B						
ate	REGISTER_B						
atee	REGISTER_B						
atolg	REGISTER_A						
c	REGISTER_A						
c	REGISTER_B						
cckhe	UNKNOWN						
cckhh	REGISTER_A						
cfarasr	REGISTER_A						
cfh	REGISTER_A						
cfh	REGISTER_B						
cfhar	REGISTER_A						
cfhd	REGISTER_B						
cfhdor	REGISTER_A						
cfhe	REGISTER_A						
cfhe	REGISTER_B						
cfhee	REGISTER_A						
cfheo	REGISTER_B						
cfho	REGISTER_A						
cfhodar	REGISTER_A						
cfhy	REGISTER_B						
ch	REGISTER_A						
ch	REGISTER_B						
cha	REGISTER_A						
chad	REGISTER_A						
chad	REGISTER_B						
chaiir	REGISTER_A						
chaim	REGISTER_B						
chair	REGISTER_A						
chair	REGISTER_B						
chak	REGISTER_B						
chakee	REGISTER_A						
chakod	REGISTER_A						
chal	REGISTER_A						
chal	REGISTER_B						
chald	REGISTER_A						
chalg	REGISTER_B						
chalk	REGISTER_B						
chalkee	REGISTER_B						
chalkeed	REGISTER_B						
chalkeeed	REGISTER_B						
chalol	REGISTER_B						
chalolk	REGISTER_B						
chalr	REGISTER_B						
chaltar	REGISTER_B						
chan	REGISTER_A						
chan	REGISTER_B						
chap	REGISTER_B						
chapch	REGISTER_A						
char	REGISTER_A		family=F_BOTANICAL_CORE;role_group=BOT;primary_section=Herbal;struct=CL_MIXED	F_BOTANICAL_CORE	BOT	Herbal	CL_MIXED
char	REGISTER_B		family=F_BOTANICAL_CORE;role_group=BOT;primary_section=Herbal;struct=CL_MIXED	F_BOTANICAL_CORE	BOT	Herbal	CL_MIXED
chas	REGISTER_A						
chat	REGISTER_B						
chcfh	REGISTER_A						
chcfh	REGISTER_B						
chcfhd	REGISTER_B						
chcfhe	REGISTER_B						
chcfhh	REGISTER_A						
chch	REGISTER_A						
chch	REGISTER_B						
chchee	REGISTER_B						
chchek	REGISTER_B						
chchet	REGISTER_A						
chchk	REGISTER_B						
chchot	REGISTER_A						
chchs	REGISTER_B						
chchst	REGISTER_A						
chcht	REGISTER_B						
chck	REGISTER_B						
chckh	REGISTER_A						
chckh	REGISTER_B						
chckh	UNKNOWN						
chckhal	REGISTER_A						
chckhd	REGISTER_A						
chckhd	REGISTER_B						
chckhe	REGISTER_A						
chckhe	REGISTER_B						
chckhed	REGISTER_A						
chckhed	REGISTER_B						
chckhee	REGISTER_A						
chckheed	REGISTER_B						
chckhh	REGISTER_A						
chckhh	REGISTER_B						
chckhod	REGISTER_A						
chckhoda	REGISTER_B						
chckhs	REGISTER_A						
chckhyd	REGISTER_B						
chckhyfch	REGISTER_B						
chcksh	REGISTER_A						
chcp	REGISTER_A						
chcp	UNKNOWN						
chcph	REGISTER_A						
chcph	REGISTER_B						
chcphar	REGISTER_B						
chcphd	REGISTER_B						
chcphdar	REGISTER_B						
chcphe	REGISTER_A						
chcphe	REGISTER_B						
chcphed	REGISTER_A						
chcphed	REGISTER_B						
chcphh	REGISTER_A						
chcphh	REGISTER_B						
chcphhd	REGISTER_B						
chcs	REGISTER_A						
chct	REGISTER_B						
chcta	REGISTER_B						
chcth	REGISTER_A						
chcth	REGISTER_B						
chcthar	REGISTER_B						
chcthd	REGISTER_B						
chcthe	REGISTER_A						
chcthe	REGISTER_B						
chcthed	REGISTER_B						
chcthh	REGISTER_A						
chcthh	REGISTER_B						
chcthih	REGISTER_B						
chctho	REGISTER_B						
chcthso	REGISTER_A						
chd	REGISTER_A						
chd	REGISTER_B						
chd	UNKNOWN						
chda	REGISTER_A						
chdail	REGISTER_A						
chdair	REGISTER_B						
chdairod	REGISTER_B						
chdal	REGISTER_A						
chdal	REGISTER_B						
chdalchd	REGISTER_B						
chdald	REGISTER_B						
chdalkair	REGISTER_B						
chdar	REGISTER_A						
chdar	REGISTER_B						
chdch	REGISTER_B						
chdchd	REGISTER_B						
chdd	REGISTER_B						
chded	REGISTER_B						
chdo	REGISTER_B						
chdol	REGISTER_A						
chdos	REGISTER_B						
chdykched	REGISTER_B						
chdypd	REGISTER_B						
che	REGISTER_A						
che	REGISTER_B						
che	UNKNOWN						
chead	REGISTER_A						
cheal	REGISTER_A						
cheal	REGISTER_B						
chealr	REGISTER_B						
cheam	REGISTER_A						
cheamar	REGISTER_B						
chean	REGISTER_A						
chear	REGISTER_A		family=F_PROC_CORE;role_group=PROC;primary_section=Recipes;struct=CL_MIXED	F_PROC_CORE	PROC	Recipes	CL_MIXED
chear	REGISTER_B		family=F_PROC_CORE;role_group=PROC;primary_section=Recipes;struct=CL_MIXED	F_PROC_CORE	PROC	Recipes	CL_MIXED
cheas	REGISTER_A						
checfh	REGISTER_B						
chech	REGISTER_A						
chech	REGISTER_B						
chechd	REGISTER_B						
cheche	REGISTER_B						
checkh	REGISTER_A						
checkh	REGISTER_B						
checkhd	REGISTER_B						
checkhe	REGISTER_A						
checkhe	REGISTER_B						
checkhed	REGISTER_B						
checkho	REGISTER_B						
checphe	REGISTER_B						
checphed	REGISTER_B						
checth	REGISTER_A						
checth	REGISTER_B						
checthd	REGISTER_B						
checthe	REGISTER_B						
checthed	REGISTER_B						
ched	REGISTER_A						
ched	REGISTER_B						
ched	UNKNOWN						
cheda	REGISTER_B						
chedacph	REGISTER_B						
chedad	REGISTER_A						
chedaiiin	REGISTER_B						
chedair	REGISTER_B						
chedal	REGISTER_B						
chedalked	REGISTER_B						
chedan	REGISTER_B						
chedar	REGISTER_A						
chedar	REGISTER_B						
chedas	REGISTER_A						
chedch	REGISTER_B						
chedche	REGISTER_B						
chede	REGISTER_B						
chedees	REGISTER_B						
chedk	REGISTER_B						
chedkal	REGISTER_B						
chedkel	REGISTER_B						
chedl	REGISTER_B						
chedo	REGISTER_A						
chedo	REGISTER_B						
chedos	REGISTER_B						
cheds	REGISTER_B						
chedy	REGISTER_B		family=F_PROC_CORE;role_group=PROC;primary_section=Biological;struct=CL_MIXED	F_PROC_CORE	PROC	Biological	CL_MIXED
chedyd	REGISTER_B						
chedykar	REGISTER_B						
chedyl	REGISTER_B						
chedyr	REGISTER_B						
chedyt	REGISTER_B						
chedyte	REGISTER_B						
chedyteok	REGISTER_B						
chee	REGISTER_A						
chee	REGISTER_B						
chee	UNKNOWN						
cheear	REGISTER_B						
cheecphee	REGISTER_A						
cheecth	REGISTER_A						
cheed	REGISTER_A						
cheed	REGISTER_B						
cheedar	REGISTER_B						
cheee	REGISTER_A						
cheee	REGISTER_B						
cheeed	REGISTER_B						
cheeen	REGISTER_A						
cheeeo	REGISTER_B						
cheeet	REGISTER_B						
cheeetch	REGISTER_A						
cheef	REGISTER_A						
cheef	REGISTER_B						
cheefar	REGISTER_B						
cheeg	REGISTER_B						
cheeir	REGISTER_B						
cheek	REGISTER_A						
cheek	REGISTER_B						
cheekan	REGISTER_B						
cheekche	REGISTER_A						
cheekd	REGISTER_A						
cheeke	REGISTER_A						
cheeke	REGISTER_B						
cheekee	REGISTER_B						
cheekeo	REGISTER_A						
cheem	REGISTER_B						
cheen	REGISTER_A						
cheen	REGISTER_B						
cheeo	REGISTER_B						
cheeod	REGISTER_A						
cheeod	REGISTER_B						
cheeoeke	REGISTER_A						
cheeokee	REGISTER_B						
cheeokseo	REGISTER_B						
cheeold	REGISTER_B						
cheeorf	REGISTER_B						
cheeos	REGISTER_A						
cheeos	REGISTER_B						
cheeot	REGISTER_A						
cheep	REGISTER_A						
cheer	REGISTER_B						
chees	REGISTER_A						
chees	REGISTER_B						
chees	UNKNOWN						
cheesees	REGISTER_A						
cheet	REGISTER_A						
cheet	REGISTER_B						
cheeta	REGISTER_B						
cheetar	REGISTER_B						
cheetee	REGISTER_B						
cheetee	UNKNOWN						
cheeyk	REGISTER_A						
cheeyte	REGISTER_B						
chef	REGISTER_B						
chefalas	REGISTER_B						
chefar	REGISTER_B						
chefch	REGISTER_B						
chefchd	REGISTER_B						
chefol	REGISTER_A						
cheg	REGISTER_A						
cheg	REGISTER_B						
cheis	UNKNOWN						
chek	REGISTER_A						
chek	REGISTER_B						
chek	UNKNOWN						
chekaiiin	REGISTER_B						
chekaim	REGISTER_B						
chekaiph	REGISTER_B						
chekaithh	REGISTER_B						
chekalchs	REGISTER_B						
chekar	REGISTER_A						
chekar	REGISTER_B						
chekch	REGISTER_A						
chekch	REGISTER_B						
chekchd	REGISTER_B						
chekchee	REGISTER_B						
cheke	REGISTER_A						
cheke	REGISTER_B						
chekear	REGISTER_B						
chekech	REGISTER_A						
cheked	REGISTER_B						
chekee	REGISTER_A						
chekee	REGISTER_B						
chekeed	REGISTER_B						
chekeek	REGISTER_B						
chekeen	REGISTER_B						
chekeo	REGISTER_A						
chekeoar	REGISTER_A						
chekeod	REGISTER_B						
chekes	REGISTER_B						
chekeys	REGISTER_A						
chekh	REGISTER_A						
chekl	REGISTER_A						
chel	REGISTER_A						
chem	REGISTER_B						
cheo	REGISTER_A		family=F_PROC_CORE;role_group=PROC;primary_section=Recipes;struct=CL_MIXED	F_PROC_CORE	PROC	Recipes	CL_MIXED
cheo	REGISTER_B		family=F_PROC_CORE;role_group=PROC;primary_section=Recipes;struct=CL_MIXED	F_PROC_CORE	PROC	Recipes	CL_MIXED
cheoar	REGISTER_B						
cheocka	REGISTER_B						
cheockh	REGISTER_A						
cheockh	REGISTER_B						
cheockhe	REGISTER_A						
cheockhe	REGISTER_B						
cheockhedch	REGISTER_B						
cheocph	REGISTER_B						
cheocphe	REGISTER_A						
cheocth	REGISTER_B						
cheocthe	REGISTER_B						
cheocthed	REGISTER_B						
cheocthee	REGISTER_B						
cheod	REGISTER_A						
cheod	REGISTER_B						
cheoda	REGISTER_A						
cheodaiiin	REGISTER_B						
cheodaiir	REGISTER_A						
cheodar	REGISTER_A						
cheodar	REGISTER_B						
cheodee	REGISTER_B						
cheodl	REGISTER_B						
cheoekar	REGISTER_B						
cheoeke	REGISTER_B						
cheoekee	REGISTER_A						
cheoepe	REGISTER_A						
cheoet	REGISTER_B						
cheoiees	REGISTER_A						
cheok	REGISTER_A						
cheok	REGISTER_B						
cheokaid	REGISTER_B						
cheokaiim	REGISTER_B						
cheokal	REGISTER_B						
cheokar	REGISTER_B						
cheokch	REGISTER_B						
cheokche	REGISTER_A						
cheokcheo	REGISTER_B						
cheoke	REGISTER_B						
cheoke	UNKNOWN						
cheoked	REGISTER_B						
cheokee	REGISTER_A						
cheokee	REGISTER_B						
cheokeeo	REGISTER_B						
cheokeeos	REGISTER_B						
cheokeo	REGISTER_B						
cheokeos	REGISTER_B						
cheokorche	UNKNOWN						
cheol	REGISTER_B		family=F_PROC_CORE;role_group=PROC;primary_section=Recipes;struct=CL_PROC_LEFT	F_PROC_CORE	PROC	Recipes	CL_PROC_LEFT
cheolch	REGISTER_B						
cheolchd	REGISTER_B						
cheolche	REGISTER_B						
cheold	REGISTER_A						
cheold	REGISTER_B						
cheolk	REGISTER_B						
cheolked	REGISTER_A						
cheolkee	REGISTER_B						
cheolkeed	REGISTER_B						
cheols	REGISTER_A						
cheols	REGISTER_B						
cheolt	REGISTER_B						
cheoltched	REGISTER_B						
cheom	REGISTER_A						
cheom	REGISTER_B						
cheook	REGISTER_B						
cheop	REGISTER_B						
cheopcheod	REGISTER_B						
cheopolteeed	REGISTER_B						
cheor	REGISTER_A		family=F_BOTANICAL_CORE;role_group=BOT;primary_section=Herbal;struct=CL_MIXED	F_BOTANICAL_CORE	BOT	Herbal	CL_MIXED
cheor	REGISTER_B		family=F_BOTANICAL_CORE;role_group=BOT;primary_section=Herbal;struct=CL_MIXED	F_BOTANICAL_CORE	BOT	Herbal	CL_MIXED
cheos	REGISTER_A						
cheos	REGISTER_B						
cheos	UNKNOWN						
cheoseese	REGISTER_A						
cheot	REGISTER_A						
cheot	REGISTER_B						
cheotar	REGISTER_A						
cheotd	REGISTER_B						
cheote	REGISTER_A						
cheote	REGISTER_B						
cheotee	REGISTER_B						
cheoteeo	REGISTER_B						
cheotyd	REGISTER_B						
chep	REGISTER_A						
chep	REGISTER_B						
chepakeo	REGISTER_B						
chepar	REGISTER_A						
chepar	REGISTER_B						
chepch	REGISTER_A						
chepch	REGISTER_B						
chepchar	REGISTER_B						
chepchd	REGISTER_B						
chepche	REGISTER_A						
chepche	REGISTER_B						
chepched	REGISTER_B						
chepchees	REGISTER_B						
chepchef	REGISTER_A						
chepchx	REGISTER_A						
cher	REGISTER_A						
cher	REGISTER_B						
cher	UNKNOWN						
ches	REGISTER_A						
ches	REGISTER_B						
chesckh	REGISTER_B						
chese	REGISTER_A						
chesokeeote	REGISTER_A						
chet	REGISTER_A						
chet	REGISTER_B						
chetalsh	REGISTER_B						
chetar	REGISTER_A						
chetar	REGISTER_B						
chetas	REGISTER_A						
chetch	REGISTER_A						
chetch	REGISTER_B						
chetchd	REGISTER_B						
chetche	REGISTER_B						
chetd	REGISTER_B						
chete	REGISTER_A						
chete	REGISTER_B						
chetech	REGISTER_B						
cheted	REGISTER_A						
cheted	REGISTER_B						
chetedar	REGISTER_B						
chetee	REGISTER_A						
chetee	REGISTER_B						
cheteed	REGISTER_A						
cheteeeos	REGISTER_B						
cheteg	REGISTER_A						
chetesescher	REGISTER_A						
chetol	REGISTER_B						
chetsh	REGISTER_B						
chetshed	REGISTER_A						
chey	REGISTER_B		family=F_PROC_CORE;role_group=PROC;primary_section=Recipes;struct=CL_MIXED	F_PROC_CORE	PROC	Recipes	CL_MIXED
cheyd	REGISTER_A						
cheyk	REGISTER_A						
cheyk	REGISTER_B						
cheyke	REGISTER_A						
cheykeche	REGISTER_B						
cheyked	REGISTER_B						
cheykeeo	REGISTER_B						
cheyl	REGISTER_B						
cheyt	REGISTER_A						
cheyt	REGISTER_B						
cheyte	REGISTER_B						
chf	REGISTER_B						
chfaikch	REGISTER_B						
chfch	REGISTER_B						
chh	REGISTER_B						
chk	REGISTER_A						
chk	REGISTER_B						
chka	REGISTER_A						
chkaidarar	REGISTER_B						
chkal	REGISTER_A						
chkal	REGISTER_B						
chkalar	REGISTER_B						
chkar	REGISTER_A						
chkar	REGISTER_B						
chkas	REGISTER_B						
chkch	REGISTER_A						
chkch	REGISTER_B						
chkchedar	REGISTER_B						
chkcheean	REGISTER_A						
chkchor	REGISTER_A						
chkd	REGISTER_A						
chke	REGISTER_A						
chke	REGISTER_B						
chkear	REGISTER_A						
chked	REGISTER_A						
chked	REGISTER_B						
chkee	REGISTER_A						
chkee	REGISTER_B						
chkeed	REGISTER_A						
chkeed	REGISTER_B						
chkeee	REGISTER_B						
chko	REGISTER_A						
chkod	REGISTER_A						
chkold	REGISTER_A						
chkorch	REGISTER_A						
chksh	REGISTER_B						
chl	REGISTER_A						
chl	REGISTER_B						
chlaiiin	REGISTER_B						
chlar	REGISTER_B						
chlchd	REGISTER_B						
chlchpshee	REGISTER_B						
chld	REGISTER_B						
chll	REGISTER_B						
chllo	REGISTER_B						
chlr	REGISTER_B						
chls	REGISTER_A						
cho	REGISTER_A		family=F_BOTANICAL_CORE;role_group=BOT;primary_section=Herbal;struct=CL_BOTANICAL	F_BOTANICAL_CORE	BOT	Herbal	CL_BOTANICAL
cho	REGISTER_B		family=F_BOTANICAL_CORE;role_group=BOT;primary_section=Herbal;struct=CL_BOTANICAL	F_BOTANICAL_CORE	BOT	Herbal	CL_BOTANICAL
choar	REGISTER_A						
choar	REGISTER_B						
chocfhd	REGISTER_B						
chocfhhg	REGISTER_A						
choch	REGISTER_A						
chochar	REGISTER_A						
chockh	REGISTER_A						
chockh	REGISTER_B						
chockhar	REGISTER_B						
chockhd	REGISTER_B						
chockhe	REGISTER_A						
chockhe	REGISTER_B						
chockhed	REGISTER_B						
chockhh	REGISTER_B						
chocph	REGISTER_A						
chocpheod	REGISTER_B						
choct	REGISTER_A						
chocth	REGISTER_A						
chocth	REGISTER_B						
chocthe	REGISTER_A						
chocthe	REGISTER_B						
chocthed	REGISTER_B						
choctheee	UNKNOWN						
chod	REGISTER_A						
chod	REGISTER_B						
chod	UNKNOWN						
chodair	REGISTER_A						
chodal	REGISTER_A						
chodalar	REGISTER_A						
chodalr	REGISTER_B						
chodar	REGISTER_A						
chodar	REGISTER_B						
chodch	REGISTER_A						
chodd	REGISTER_A						
chodd	REGISTER_B						
chode	REGISTER_A						
chodl	REGISTER_A						
chodo	REGISTER_A						
chodold	REGISTER_A						
chodr	REGISTER_A						
chodr	REGISTER_B						
choef	REGISTER_B						
choekch	REGISTER_B						
choekchch	REGISTER_A						
choeke	REGISTER_A						
choekee	REGISTER_A						
choekeeos	REGISTER_A						
choetch	REGISTER_A						
choete	REGISTER_B						
choeteed	REGISTER_B						
chof	REGISTER_A						
chofal	REGISTER_B						
chofch	REGISTER_A						
chofch	REGISTER_B						
chofchd	REGISTER_B						
choiin	REGISTER_A						
choikh	REGISTER_A						
choikhed	REGISTER_A						
choiph	REGISTER_B						
chok	REGISTER_A						
chok	REGISTER_B						
chokair	REGISTER_B						
chokal	REGISTER_A						
chokal	REGISTER_B						
chokan	REGISTER_A						
chokar	REGISTER_A						
chokar	REGISTER_B						
chokch	REGISTER_A						
chokch	REGISTER_B						
chokche	REGISTER_A						
chokche	REGISTER_B						
chokched	REGISTER_B						
chokcheo	REGISTER_A						
chokcho	REGISTER_A						
choke	REGISTER_A						
choke	REGISTER_B						
choked	REGISTER_B						
chokedair	REGISTER_B						
chokee	REGISTER_A						
chokee	REGISTER_B						
chokeear	REGISTER_B						
chokeed	REGISTER_A						
chokeed	REGISTER_B						
chokeee	REGISTER_A						
chokeee	REGISTER_B						
chokeeo	REGISTER_A						
chokees	REGISTER_B						
choko	REGISTER_A						
chokok	REGISTER_A						
chokold	REGISTER_A						
chokor	UNKNOWN						
choks	REGISTER_A						
choksh	REGISTER_B						
chokyt	REGISTER_A						
chol	REGISTER_A		family=F_BOTANICAL_CORE;role_group=BOT;primary_section=Herbal;struct=CL_BOTANICAL	F_BOTANICAL_CORE	BOT	Herbal	CL_BOTANICAL
chol	REGISTER_B		family=F_BOTANICAL_CORE;role_group=BOT;primary_section=Herbal;struct=CL_BOTANICAL	F_BOTANICAL_CORE	BOT	Herbal	CL_BOTANICAL
chol	UNKNOWN		family=F_BOTANICAL_CORE;role_group=BOT;primary_section=Herbal;struct=CL_BOTANICAL	F_BOTANICAL_CORE	BOT	Herbal	CL_BOTANICAL
cholair	REGISTER_B						
cholair	UNKNOWN						
cholar	REGISTER_B						
cholch	REGISTER_A						
cholch	REGISTER_B						
cholche	REGISTER_B						
cholched	REGISTER_B						
chold	REGISTER_A						
chold	REGISTER_B						
choldar	REGISTER_A						
choldch	REGISTER_A						
cholf	REGISTER_B						
cholfch	REGISTER_B						
cholk	REGISTER_B						
cholkar	REGISTER_B						
cholkch	REGISTER_B						
cholkche	REGISTER_B						
cholkched	REGISTER_B						
cholkee	REGISTER_B						
cholkeed	REGISTER_A						
cholkeed	REGISTER_B						
cholkeee	REGISTER_B						
cholkeeed	REGISTER_B						
cholkeod	REGISTER_B						
cholkshed	REGISTER_B						
cholo	REGISTER_A						
cholo	REGISTER_B						
cholol	REGISTER_A						
cholols	REGISTER_A						
cholols	REGISTER_B						
cholp	REGISTER_A						
cholpchd	REGISTER_B						
cholral	REGISTER_B						
chols	REGISTER_A						
cholt	REGISTER_A						
cholt	REGISTER_B						
choltal	REGISTER_B						
choltar	REGISTER_B						
cholx	REGISTER_B						
chom	REGISTER_A						
chon	REGISTER_A						
choolkee	REGISTER_B						
chop	REGISTER_A						
chop	REGISTER_B						
chopar	REGISTER_B						
chopch	REGISTER_A						
chopch	REGISTER_B						
chopchd	REGISTER_B						
chopche	REGISTER_B						
chopche	UNKNOWN						
chopched	REGISTER_B						
chopchee	REGISTER_A						
chopcheopch	REGISTER_A						
chopcho	REGISTER_A						
chopd	REGISTER_A						
chopo	REGISTER_B						
chor	REGISTER_A		family=F_BOTANICAL_CORE;role_group=BOT;primary_section=Herbal;struct=CL_BOTANICAL	F_BOTANICAL_CORE	BOT	Herbal	CL_BOTANICAL
chor	REGISTER_B		family=F_BOTANICAL_CORE;role_group=BOT;primary_section=Herbal;struct=CL_BOTANICAL	F_BOTANICAL_CORE	BOT	Herbal	CL_BOTANICAL
choral	REGISTER_A						
chorch	REGISTER_A						
chord	REGISTER_A						
choroch	REGISTER_A						
choroiin	REGISTER_A						
chorolk	REGISTER_B						
chorom	REGISTER_A						
choross	REGISTER_A						
chos	REGISTER_A						
chos	REGISTER_B						
chosals	REGISTER_A						
chosar	REGISTER_A						
chosch	REGISTER_A						
chosh	REGISTER_A						
choshyd	REGISTER_B						
chosor	REGISTER_A						
chot	REGISTER_A						
chot	REGISTER_B						
chotair	REGISTER_B						
chotais	REGISTER_A						
chotals	REGISTER_A						
chotar	REGISTER_A						
chotar	REGISTER_B						
chotch	REGISTER_A						
chotch	REGISTER_B						
chotchd	REGISTER_B						
chotche	REGISTER_A						
chotched	REGISTER_B						
chotcheytch	REGISTER_A						
chotchs	REGISTER_B						
chote	REGISTER_A						
chote	REGISTER_B						
chotear	REGISTER_B						
choted	REGISTER_A						
choted	REGISTER_B						
chotee	REGISTER_A						
chotee	REGISTER_B						
chotee	UNKNOWN						
choteed	REGISTER_A						
choteee	REGISTER_A						
choteok	REGISTER_A						
choteol	REGISTER_A						
choteos	REGISTER_A						
choto	REGISTER_A						
choto	REGISTER_B						
chotols	REGISTER_A						
chotols	REGISTER_B						
chots	REGISTER_A						
chotsh	REGISTER_A						
chotshe	REGISTER_B						
chotyokch	REGISTER_A						
chotyr	REGISTER_B						
choypshed	REGISTER_B						
chp	REGISTER_A						
chp	REGISTER_B						
chp	UNKNOWN						
chpadar	REGISTER_A						
chpaiike	REGISTER_B						
chpal	REGISTER_B						
chpar	REGISTER_A						
chpch	REGISTER_A						
chpch	REGISTER_B						
chpchar	REGISTER_B						
chpche	REGISTER_A						
chpche	REGISTER_B						
chpched	REGISTER_B						
chpcheod	REGISTER_B						
chpcheos	REGISTER_A						
chpchs	REGISTER_B						
chpchshd	REGISTER_B						
chpd	REGISTER_B						
chpeeee	REGISTER_B						
chpiir	REGISTER_A						
chpkcheos	REGISTER_B						
chpsheed	REGISTER_B						
chr	REGISTER_A						
chr	REGISTER_B						
chr	UNKNOWN						
chrk	REGISTER_A						
chs	REGISTER_A						
chs	REGISTER_B						
chs	UNKNOWN						
chsamok	REGISTER_B						
chsar	REGISTER_A						
chsd	REGISTER_A						
chsd	REGISTER_B						
chse	REGISTER_A						
chse	REGISTER_B						
chsea	REGISTER_B						
chsee	REGISTER_A						
chsh	REGISTER_A						
chshd	REGISTER_A						
chshek	REGISTER_A						
chsho	REGISTER_B						
chshot	REGISTER_A						
chsk	REGISTER_B						
chskar	REGISTER_B						
chsm	REGISTER_A						
chso	REGISTER_B						
cht	REGISTER_A						
cht	REGISTER_B						
chtaem	REGISTER_A						
chtaiir	REGISTER_B						
chtair	REGISTER_B						
chtal	REGISTER_B						
chtald	REGISTER_B						
chtar	REGISTER_A						
chtar	REGISTER_B						
chtch	REGISTER_A						
chtch	REGISTER_B						
chtchyf	REGISTER_A						
chte	REGISTER_B						
chted	REGISTER_B						
chtedytar	REGISTER_A						
chtee	REGISTER_A						
chtee	REGISTER_B						
chtee	UNKNOWN						
chteokeeiin	REGISTER_A						
chtl	REGISTER_B						
chtod	REGISTER_A						
chtoiin	REGISTER_A						
chtoith	REGISTER_A						
chtos	REGISTER_B						
chtshar	REGISTER_A						
chxar	REGISTER_B						
chyd	REGISTER_A						
chyk	REGISTER_A						
chyk	REGISTER_B						
chykald	REGISTER_A						
chykch	REGISTER_A						
chykchr	REGISTER_B						
chyke	REGISTER_A						
chyke	REGISTER_B						
chykeed	REGISTER_B						
chym	REGISTER_B						
chypald	REGISTER_B						
chypch	REGISTER_A						
chyqo	REGISTER_A						
chyt	REGISTER_A						
chyt	REGISTER_B						
chyte	REGISTER_B						
chytee	REGISTER_B						
ck	REGISTER_A						
ck	REGISTER_B						
ckch	REGISTER_A						
ckcho	REGISTER_A						
cke	REGISTER_A						
cke	REGISTER_B						
ckh	REGISTER_A						
ckh	REGISTER_B						
ckhar	REGISTER_A						
ckhar	REGISTER_B						
ckhd	REGISTER_A						
ckhd	REGISTER_B						
ckhddl	REGISTER_B						
ckhe	REGISTER_A						
ckhe	REGISTER_B						
ckhear	REGISTER_A						
ckheckh	REGISTER_A						
ckhed	REGISTER_A						
ckhed	REGISTER_B						
ckhee	REGISTER_A						
ckhee	REGISTER_B						
ckheee	REGISTER_A						
ckheo	REGISTER_A						
ckheo	REGISTER_B						
ckheod	REGISTER_A						
ckheodar	REGISTER_A						
ckheoke	REGISTER_A						
ckheos	REGISTER_A						
ckheos	REGISTER_B						
ckhh	REGISTER_A						
ckhhe	REGISTER_A						
ckho	REGISTER_A						
ckho	REGISTER_B						
ckhoch	REGISTER_A						
ckhocth	REGISTER_A						
ckhod	REGISTER_B						
ckhoiin	REGISTER_A						
ckhol	REGISTER_A						
ckhold	REGISTER_A						
ckhols	REGISTER_A						
ckhor	REGISTER_B						
ckhos	REGISTER_A						
ckhs	REGISTER_A						
ckhyd	REGISTER_B						
ckhydom	REGISTER_A						
ckhyds	REGISTER_A						
ckoo	REGISTER_A						
cksh	REGISTER_B						
co	REGISTER_A						
coek	REGISTER_A						
cp	REGISTER_A						
cpar	REGISTER_B						
cpch	REGISTER_B						
cpchet	REGISTER_A						
cph	REGISTER_A						
cph	REGISTER_B						
cph	UNKNOWN						
cphan	REGISTER_B						
cphar	REGISTER_A						
cpharom	REGISTER_A						
cphchar	REGISTER_A						
cphe	REGISTER_A						
cphe	REGISTER_B						
cpheal	REGISTER_A						
cpheckh	REGISTER_A						
cphed	REGISTER_A						
cphed	REGISTER_B						
cphee	REGISTER_A						
cphee	REGISTER_B						
cphees	REGISTER_B						
cpheo	REGISTER_A						
cpheo	REGISTER_B						
cpheocth	REGISTER_A						
cpheod	REGISTER_A						
cpheodar	REGISTER_A						
cphes	REGISTER_A						
cphh	REGISTER_A						
cphheg	REGISTER_B						
cphhof	REGISTER_A						
cpho	REGISTER_A						
cpho	REGISTER_B						
cphoch	REGISTER_B						
cphod	REGISTER_A						
cphodaiils	REGISTER_A						
cphodales	REGISTER_A						
cphoeed	REGISTER_A						
cphoith	REGISTER_B						
cphokch	REGISTER_A						
cphold	REGISTER_A						
cpholk	REGISTER_B						
cpholror	REGISTER_B						
cphom	REGISTER_A						
cphorods	REGISTER_A						
cphyd	REGISTER_A						
cs	REGISTER_A						
cs	REGISTER_B						
cse	REGISTER_B						
cseckhd	REGISTER_B						
csed	REGISTER_A						
csed	REGISTER_B						
csedar	REGISTER_B						
csedl	REGISTER_B						
csee	REGISTER_B						
cseed	REGISTER_B						
cseek	REGISTER_A						
cseeod	REGISTER_B						
csees	REGISTER_B						
cseo	REGISTER_B						
cseteee	REGISTER_B						
cskes	UNKNOWN						
csoek	REGISTER_A						
ct	REGISTER_A						
ctar	REGISTER_B						
ctch	REGISTER_A						
cte	REGISTER_A						
cth	REGISTER_A						
cth	REGISTER_B						
cth	UNKNOWN						
cthachcth	REGISTER_A						
cthaichar	REGISTER_A						
cthaild	REGISTER_A						
cthar	REGISTER_A						
cthar	REGISTER_B						
ctharad	REGISTER_B						
cthch	REGISTER_A						
cthch	REGISTER_B						
cthckeom	REGISTER_A						
cthd	REGISTER_A						
cthd	REGISTER_B						
cthdaoto	REGISTER_A						
cthe	REGISTER_A						
cthe	REGISTER_B						
cthed	REGISTER_A						
cthed	REGISTER_B						
cthee	REGISTER_A						
cthee	REGISTER_B						
ctheea	REGISTER_A						
cthees	REGISTER_A						
ctheet	REGISTER_B						
ctheo	REGISTER_A						
ctheockhosho	REGISTER_A						
ctheod	REGISTER_A						
ctheod	REGISTER_B						
ctheol	REGISTER_A						
cther	REGISTER_B						
cthes	REGISTER_A						
cthes	REGISTER_B						
cthh	REGISTER_A						
cthh	REGISTER_B						
cthh	UNKNOWN						
cthl	REGISTER_A						
ctho	REGISTER_A						
cthoar	REGISTER_A						
cthoch	REGISTER_A						
cthod	REGISTER_A						
cthodaiis	REGISTER_A						
cthodd	REGISTER_A						
cthodoal	REGISTER_A						
cthoep	REGISTER_B						
cthog	REGISTER_A						
cthoiin	REGISTER_A						
cthol	REGISTER_A		family=F_BOTANICAL_CORE;role_group=BOT;primary_section=Herbal;struct=CL_BOTANICAL	F_BOTANICAL_CORE	BOT	Herbal	CL_BOTANICAL
cthol	REGISTER_B		family=F_BOTANICAL_CORE;role_group=BOT;primary_section=Herbal;struct=CL_BOTANICAL	F_BOTANICAL_CORE	BOT	Herbal	CL_BOTANICAL
cthold	REGISTER_A						
ctholdar	REGISTER_A						
cthols	REGISTER_A						
cthom	REGISTER_A						
cthor	REGISTER_A						
cthor	REGISTER_B						
cthosh	REGISTER_A						
cthosm	REGISTER_A						
cthres	REGISTER_A						
cths	REGISTER_A						
cthyd	REGISTER_A						
cthyd	REGISTER_B						
cto	REGISTER_A						
ctoiin	REGISTER_A						
ctos	REGISTER_A						
d	REGISTER_A						
d	REGISTER_B						
d	UNKNOWN						
da	REGISTER_A						
da	REGISTER_B						
dad	REGISTER_A						
dad	REGISTER_B						
daein	UNKNOWN						
dag	REGISTER_B						
daicth	REGISTER_A						
daid	REGISTER_A						
daii	REGISTER_A						
daiid	REGISTER_A						
daiid	REGISTER_B						
daiiid	REGISTER_B						
daiiin	REGISTER_A						
daiiin	REGISTER_B						
daiiirch	REGISTER_A						
daiild	REGISTER_A						
daiim	REGISTER_A						
daiim	REGISTER_B						
daiin	REGISTER_A		family=F_BOTANICAL_CORE;role_group=BOT;primary_section=Herbal;struct=CL_BOTANICAL	F_BOTANICAL_CORE	BOT	Herbal	CL_BOTANICAL
daiind	REGISTER_B						
daiir	REGISTER_A						
daiir	REGISTER_B						
daiis	REGISTER_A						
daiis	REGISTER_B						
daiit	REGISTER_A						
daik	REGISTER_A						
daike	REGISTER_A						
daikhyk	REGISTER_B						
dail	REGISTER_A						
daim	REGISTER_A						
daim	REGISTER_B						
daimd	REGISTER_A						
daimm	REGISTER_A						
daimom	REGISTER_A						
dain	REGISTER_A		family=F_BOTANICAL_CORE;role_group=BOT;primary_section=Herbal;struct=CL_MIXED	F_BOTANICAL_CORE	BOT	Herbal	CL_MIXED
daing	REGISTER_A						
dainke	REGISTER_B						
dainl	REGISTER_A						
dair	REGISTER_A		family=F_BOTANICAL_CORE;role_group=BOT;primary_section=Herbal;struct=CL_MIXED	F_BOTANICAL_CORE	BOT	Herbal	CL_MIXED
dair	REGISTER_B		family=F_BOTANICAL_CORE;role_group=BOT;primary_section=Herbal;struct=CL_MIXED	F_BOTANICAL_CORE	BOT	Herbal	CL_MIXED
dairair	REGISTER_A						
dairair	REGISTER_B						
dairar	REGISTER_B						
daird	REGISTER_A						
dairi	REGISTER_B						
dairin	REGISTER_A						
dairo	REGISTER_A						
dairom	REGISTER_A						
dairyd	REGISTER_B						
dais	REGISTER_A						
dais	REGISTER_B						
daisin	REGISTER_A						
dait	REGISTER_A						
dak	REGISTER_A						
dakar	REGISTER_A						
dakee	REGISTER_A						
dal	REGISTER_A		family=F_BOTANICAL_CORE;role_group=BOT;primary_section=Herbal;struct=CL_MIXED	F_BOTANICAL_CORE	BOT	Herbal	CL_MIXED
dal	REGISTER_B		family=F_BOTANICAL_CORE;role_group=BOT;primary_section=Herbal;struct=CL_MIXED	F_BOTANICAL_CORE	BOT	Herbal	CL_MIXED
dala	REGISTER_A						
dalal	REGISTER_A						
dalald	REGISTER_B						
dalar	REGISTER_A						
dalar	REGISTER_B						
dalas	REGISTER_B						
dalch	REGISTER_A						
dalch	REGISTER_B						
dalchckh	REGISTER_B						
dalchd	REGISTER_B						
dalched	REGISTER_B						
dalched	UNKNOWN						
dalches	REGISTER_A						
dald	REGISTER_A						
dald	REGISTER_B						
daldar	REGISTER_B						
dalde	REGISTER_A						
daleesd	REGISTER_B						
dalfch	REGISTER_B						
dalg	REGISTER_A						
dalk	REGISTER_B						
dalkalyt	REGISTER_B						
dalkar	REGISTER_B						
dalked	REGISTER_B						
dalkeee	REGISTER_B						
dalm	REGISTER_B						
dalo	REGISTER_B						
dalocthh	REGISTER_A						
dalok	REGISTER_B						
dalols	REGISTER_B						
dalom	REGISTER_B						
dalor	REGISTER_B						
dalr	REGISTER_B						
dals	REGISTER_A						
dals	REGISTER_B						
dalsh	REGISTER_B						
dalshd	REGISTER_A						
dalshd	REGISTER_B						
dalshedo	REGISTER_A						
dalted	REGISTER_B						
dalteosh	REGISTER_B						
dalychs	REGISTER_B						
dalyd	REGISTER_A						
damo	REGISTER_A						
damom	REGISTER_B						
dan	REGISTER_A						
dan	REGISTER_B						
dar	REGISTER_A		family=F_BOTANICAL_CORE;role_group=BOT;primary_section=Herbal;struct=CL_MIXED	F_BOTANICAL_CORE	BOT	Herbal	CL_MIXED
dar	REGISTER_B		family=F_BOTANICAL_CORE;role_group=BOT;primary_section=Herbal;struct=CL_MIXED	F_BOTANICAL_CORE	BOT	Herbal	CL_MIXED
dar	UNKNOWN		family=F_BOTANICAL_CORE;role_group=BOT;primary_section=Herbal;struct=CL_MIXED	F_BOTANICAL_CORE	BOT	Herbal	CL_MIXED
daraiiin	REGISTER_A						
daraiinm	REGISTER_A						
darailched	REGISTER_B						
darair	REGISTER_B						
daral	REGISTER_B						
darala	REGISTER_A						
darar	REGISTER_A						
darch	REGISTER_A						
dard	REGISTER_A						
dardyr	REGISTER_B						
dariin	REGISTER_B						
daro	REGISTER_A						
daro	REGISTER_B						
darolm	REGISTER_A						
darom	REGISTER_A						
darom	REGISTER_B						
daror	REGISTER_A						
darord	REGISTER_B						
darshe	REGISTER_B						
das	REGISTER_A						
das	REGISTER_B						
dasad	REGISTER_A						
dasd	REGISTER_B						
datee	REGISTER_B						
dayt	REGISTER_A						
dch	REGISTER_A						
dch	REGISTER_B						
dchair	REGISTER_B						
dchar	REGISTER_A						
dchckh	REGISTER_A						
dchd	REGISTER_A						
dchd	REGISTER_B						
dchdar	REGISTER_B						
dchdas	REGISTER_B						
dche	REGISTER_A						
dche	REGISTER_B						
dched	REGISTER_A						
dched	REGISTER_B						
dchee	REGISTER_B						
dcheed	REGISTER_A						
dcheee	REGISTER_A						
dcheek	REGISTER_A						
dchefoe	REGISTER_B						
dcheok	REGISTER_A						
dchir	REGISTER_A						
dchm	REGISTER_A						
dchod	REGISTER_A						
dchog	REGISTER_A						
dchokch	REGISTER_A						
dchol	REGISTER_A						
dchot	REGISTER_A						
dchreo	REGISTER_B						
dchs	REGISTER_B						
dchyd	REGISTER_A						
dchyk	REGISTER_A						
dchyr	UNKNOWN						
dckh	REGISTER_B						
dcsed	REGISTER_A						
dcth	REGISTER_A						
dd	REGISTER_A						
ddl	REGISTER_A						
de	REGISTER_B						
ded	REGISTER_A						
ded	REGISTER_B						
dee	REGISTER_A						
dee	REGISTER_B						
deeaiir	REGISTER_A						
deeamsh	REGISTER_A						
deed	REGISTER_B						
deedes	REGISTER_B						
deee	REGISTER_A						
deeed	REGISTER_B						
deeeod	REGISTER_A						
deees	REGISTER_A						
deeet	REGISTER_A						
deeo	REGISTER_B						
deeschd	REGISTER_A						
defo	REGISTER_A						
dein	REGISTER_A						
del	UNKNOWN						
dese	REGISTER_A						
dg	REGISTER_A						
dgs	REGISTER_A						
diiin	REGISTER_A						
diir	REGISTER_B						
dk	REGISTER_A						
dk	REGISTER_B						
dkair	REGISTER_B						
dkals	REGISTER_A						
dkar	REGISTER_B						
dkarar	REGISTER_B						
dkchs	REGISTER_B						
dked	REGISTER_A						
dked	REGISTER_B						
dkedar	REGISTER_A						
dkee	REGISTER_A						
dkee	REGISTER_B						
dkeeeg	REGISTER_A						
dksh	REGISTER_A						
dkshe	REGISTER_B						
dl	REGISTER_A						
dl	REGISTER_B						
dla	REGISTER_B						
dlchd	REGISTER_B						
dlk	REGISTER_B						
dlls	REGISTER_B						
dlocta	REGISTER_A						
dlos	REGISTER_A						
dlr	REGISTER_B						
dm	REGISTER_B						
do	REGISTER_A						
do	REGISTER_B						
dockh	REGISTER_A						
doctho	REGISTER_B						
dod	REGISTER_A						
dodar	REGISTER_A						
dodar	REGISTER_B						
dodl	REGISTER_A						
dodyd	REGISTER_B						
doed	REGISTER_A						
doeeeesm	REGISTER_A						
doiiin	REGISTER_B						
doiin	REGISTER_A						
doiin	REGISTER_B						
doiir	REGISTER_A						
doiir	REGISTER_B						
doikh	REGISTER_A						
doin	REGISTER_B						
doiros	REGISTER_B						
doith	REGISTER_A						
dok	REGISTER_A						
dokech	REGISTER_A						
doked	REGISTER_A						
dol	REGISTER_A		family=F_BOTANICAL_CORE;role_group=BOT;primary_section=Herbal;struct=CL_MIXED	F_BOTANICAL_CORE	BOT	Herbal	CL_MIXED
dol	REGISTER_B		family=F_BOTANICAL_CORE;role_group=BOT;primary_section=Herbal;struct=CL_MIXED	F_BOTANICAL_CORE	BOT	Herbal	CL_MIXED
dolar	REGISTER_A						
dolar	REGISTER_B						
dolchds	REGISTER_A						
dolche	REGISTER_B						
dolched	REGISTER_B						
dolchee	REGISTER_A						
dolcheed	REGISTER_A						
dolchl	REGISTER_B						
dolcho	REGISTER_A						
dolchsyckhe	REGISTER_A						
dold	REGISTER_A						
dold	REGISTER_B						
doleed	REGISTER_A						
doleee	REGISTER_A						
doleod	REGISTER_A						
dolfched	REGISTER_B						
dolk	REGISTER_B						
dolkch	REGISTER_B						
dolked	REGISTER_A						
dolkeed	REGISTER_B						
dolo	REGISTER_A						
dolsh	REGISTER_A						
dolshed	REGISTER_B						
doltshd	REGISTER_B						
dom	REGISTER_A						
dom	REGISTER_B						
dor	REGISTER_A		family=F_BOTANICAL_CORE;role_group=BOT;primary_section=Herbal;struct=CL_BOTANICAL	F_BOTANICAL_CORE	BOT	Herbal	CL_BOTANICAL
dor	REGISTER_B		family=F_BOTANICAL_CORE;role_group=BOT;primary_section=Herbal;struct=CL_BOTANICAL	F_BOTANICAL_CORE	BOT	Herbal	CL_BOTANICAL
dorch	REGISTER_A						
dorg	REGISTER_A						
dorl	REGISTER_A						
dorshef	REGISTER_A						
dos	REGISTER_B						
dot	REGISTER_A						
doteoda	REGISTER_A						
dotse	REGISTER_B						
dp	REGISTER_B						
dpch	REGISTER_A						
dpched	REGISTER_B						
dr	REGISTER_B						
ds	REGISTER_A						
ds	REGISTER_B						
dsh	REGISTER_A						
dsh	REGISTER_B						
dshal	REGISTER_B						
dshd	REGISTER_B						
dshe	REGISTER_A						
dshe	REGISTER_B						
dshed	REGISTER_B						
dshee	REGISTER_A						
dsheed	REGISTER_A						
dsheed	REGISTER_B						
dsho	REGISTER_A						
dsholyd	REGISTER_A						
dt	REGISTER_B						
dtchan	REGISTER_A						
dtedair	REGISTER_B						
dto	REGISTER_A						
dxar	REGISTER_B						
dy	REGISTER_B		family=F_BOTANICAL_CORE;role_group=BOT;primary_section=Herbal;struct=CL_BOTANICAL	F_BOTANICAL_CORE	BOT	Herbal	CL_BOTANICAL
dychear	REGISTER_A						
dycheckh	REGISTER_A						
dyched	REGISTER_A						
dyched	REGISTER_B						
dyd	REGISTER_A						
dydaim	REGISTER_B						
dydas	REGISTER_A						
dydch	REGISTER_A						
dydyd	REGISTER_A						
dyeees	REGISTER_A						
dyfchd	REGISTER_A						
dyk	REGISTER_A						
dyk	REGISTER_B						
dykch	REGISTER_A						
dyke	REGISTER_A						
dyked	REGISTER_A						
dykeed	REGISTER_B						
dylches	REGISTER_B						
dym	REGISTER_B						
dyotyds	REGISTER_A						
dypch	REGISTER_A						
dys	REGISTER_A						
dyt	REGISTER_A						
dyt	REGISTER_B						
dytar	REGISTER_B						
dytch	REGISTER_A						
dyte	REGISTER_B						
dyted	REGISTER_A						
dytor	REGISTER_A						
dytsh	REGISTER_B						
dytshed	REGISTER_B						
dytyd	REGISTER_A						
e	REGISTER_A						
eair	REGISTER_A						
eal	REGISTER_B						
ear	REGISTER_B						
ech	REGISTER_B						
echa	REGISTER_A						
echkol	REGISTER_B						
echt	REGISTER_A						
ee	REGISTER_A						
ee	REGISTER_B						
eear	REGISTER_A						
eeckh	REGISTER_A						
eed	REGISTER_A						
eed	REGISTER_B						
eed	UNKNOWN						
eee	REGISTER_A						
eee	REGISTER_B						
eeecfh	REGISTER_B						
eeed	REGISTER_A						
eeed	REGISTER_B						
eeed	UNKNOWN						
eeee	REGISTER_A						
eeeod	REGISTER_B						
eeer	REGISTER_B						
eees	REGISTER_A						
eees	REGISTER_B						
eek	REGISTER_B						
een	REGISTER_A						
eeod	REGISTER_B						
eeos	REGISTER_B						
eeoseeos	REGISTER_B						
ees	REGISTER_A						
ees	REGISTER_B						
eese	REGISTER_A						
eesos	REGISTER_B						
eesyd	REGISTER_B						
eetees	REGISTER_A						
efaloir	REGISTER_B						
efched	REGISTER_B						
ek	REGISTER_A						
ek	REGISTER_B						
ekais	REGISTER_A						
ekar	REGISTER_B						
eke	REGISTER_A						
eked	REGISTER_A						
ekee	REGISTER_B						
ekeol	REGISTER_B						
ekokee	REGISTER_A						
eos	REGISTER_A						
ep	REGISTER_A						
ep	REGISTER_B						
epair	REGISTER_A						
epch	REGISTER_A						
epche	REGISTER_B						
ereol	REGISTER_B						
es	REGISTER_B						
esech	REGISTER_A						
esed	REGISTER_A						
eses	REGISTER_A						
et	REGISTER_A						
et	REGISTER_B						
etar	REGISTER_B						
etch	REGISTER_A						
etche	REGISTER_A						
ete	REGISTER_A						
eteed	REGISTER_B						
eteeys	REGISTER_A						
eteodys	UNKNOWN						
etod	REGISTER_A						
etodaithe	REGISTER_B						
etyd	REGISTER_A						
f	REGISTER_A						
f	REGISTER_B						
faim	REGISTER_B						
famom	REGISTER_B						
far	REGISTER_A						
far	REGISTER_B						
fard	REGISTER_B						
farshee	REGISTER_B						
fch	REGISTER_A						
fch	REGISTER_B						
fchcfh	REGISTER_B						
fchcho	REGISTER_A						
fchd	REGISTER_A						
fchd	REGISTER_B						
fchdar	REGISTER_B						
fche	REGISTER_A						
fche	REGISTER_B						
fched	REGISTER_A						
fched	REGISTER_B						
fchede	REGISTER_B						
fchedys	REGISTER_B						
fchee	REGISTER_B						
fcheod	REGISTER_B						
fcheos	REGISTER_A						
fcho	REGISTER_A						
fchocthar	REGISTER_B						
fchodyche	REGISTER_A						
fchok	REGISTER_B						
fchol	REGISTER_A						
fchold	REGISTER_A						
fchom	REGISTER_A						
fchos	REGISTER_B						
fchs	REGISTER_B						
fchsom	REGISTER_B						
fdyk	REGISTER_B						
feedl	REGISTER_A						
feeed	REGISTER_A						
fo	REGISTER_A						
foar	REGISTER_A						
fol	REGISTER_A						
folcfhh	REGISTER_A						
folch	REGISTER_A						
fold	REGISTER_A						
fse	REGISTER_A						
fshed	REGISTER_B						
fshodch	REGISTER_A						
fsholom	REGISTER_A						
fyd	REGISTER_B						
fyshe	REGISTER_B						
g	REGISTER_A						
g	REGISTER_B						
gm	REGISTER_B						
ihar	REGISTER_B						
iiin	REGISTER_B						
iiincheom	REGISTER_A						
iir	REGISTER_A						
iir	REGISTER_B						
iirch	REGISTER_B						
in	REGISTER_B						
iph	REGISTER_A						
ith	REGISTER_B						
ithe	REGISTER_B						
ithh	REGISTER_A						
k	REGISTER_A						
k	REGISTER_B						
ka	REGISTER_A						
kaiiin	REGISTER_A						
kaiiin	REGISTER_B						
kaiis	REGISTER_B						
kaiishd	REGISTER_B						
kail	REGISTER_B						
kair	REGISTER_A						
kair	REGISTER_B						
kais	REGISTER_B						
kaishd	REGISTER_B						
kaith	REGISTER_B						
kal	REGISTER_B						
kalchd	REGISTER_B						
kalched	REGISTER_B						
kald	REGISTER_A						
kald	REGISTER_B						
kaldaim	REGISTER_B						
kalk	REGISTER_B						
kalos	REGISTER_B						
kamd	REGISTER_B						
kan	REGISTER_A						
kan	REGISTER_B						
kar	REGISTER_A		family=F_BOTANICAL_CORE;role_group=BOT;primary_section=Herbal;struct=CL_MIXED	F_BOTANICAL_CORE	BOT	Herbal	CL_MIXED
kar	REGISTER_B		family=F_BOTANICAL_CORE;role_group=BOT;primary_section=Herbal;struct=CL_MIXED	F_BOTANICAL_CORE	BOT	Herbal	CL_MIXED
kara	REGISTER_A						
karaim	REGISTER_B						
karain	REGISTER_B						
karar	REGISTER_B						
kararo	REGISTER_B						
karch	REGISTER_B						
kard	REGISTER_B						
kas	REGISTER_B						
kch	REGISTER_A						
kch	REGISTER_B						
kchar	REGISTER_A						
kchd	REGISTER_A						
kchd	REGISTER_B						
kchdar	REGISTER_B						
kche	REGISTER_A						
kche	REGISTER_B						
kched	REGISTER_A						
kched	REGISTER_B						
kchee	REGISTER_A						
kchee	REGISTER_B						
kchek	REGISTER_B						
kcheo	REGISTER_B						
kcheod	REGISTER_B						
kcheodar	REGISTER_B						
kcheol	REGISTER_A						
kchet	REGISTER_B						
kchm	REGISTER_A						
kcho	REGISTER_A						
kchoan	REGISTER_A						
kchoch	REGISTER_B						
kchod	REGISTER_A						
kchodan	REGISTER_A						
kchokch	REGISTER_A						
kchom	REGISTER_A						
kchorch	REGISTER_A						
kchos	REGISTER_A						
kchs	REGISTER_A						
ke	REGISTER_A						
ke	REGISTER_B						
kech	REGISTER_A						
kech	REGISTER_B						
kechd	REGISTER_B						
keche	REGISTER_B						
keched	REGISTER_B						
kecheokeo	REGISTER_B						
kechodshe	REGISTER_B						
ked	REGISTER_A						
ked	REGISTER_B						
kedaiiin	REGISTER_B						
kedair	REGISTER_B						
kedar	REGISTER_A						
kedar	REGISTER_B						
kedyd	REGISTER_B						
kee	REGISTER_A						
kee	REGISTER_B						
keear	REGISTER_B						
keech	REGISTER_A						
keech	REGISTER_B						
keeche	REGISTER_B						
keed	REGISTER_A						
keed	REGISTER_B						
keedas	REGISTER_B						
keedeed	REGISTER_B						
keee	REGISTER_A						
keee	REGISTER_B						
keeed	REGISTER_B						
keeees	REGISTER_A						
keeeo	REGISTER_B						
keees	REGISTER_A						
keem	REGISTER_A						
keeo	REGISTER_A						
keeo	REGISTER_B						
keeod	REGISTER_A						
keeod	REGISTER_B						
keeodar	REGISTER_B						
keeokech	REGISTER_A						
keeolshe	REGISTER_B						
keeos	REGISTER_B						
keesh	REGISTER_B						
keesho	REGISTER_B						
keo	REGISTER_A						
keo	REGISTER_B						
keoar	REGISTER_B						
keocth	REGISTER_A						
keocthed	REGISTER_B						
keod	REGISTER_A						
keod	REGISTER_B						
keodar	REGISTER_B						
keodk	REGISTER_B						
keok	REGISTER_A						
keol	REGISTER_A						
keol	REGISTER_B						
keolche	REGISTER_A						
keos	REGISTER_A						
kesd	REGISTER_B						
kesh	REGISTER_B						
keshe	REGISTER_B						
keshed	REGISTER_B						
kiin	REGISTER_B						
kl	REGISTER_B						
ko	REGISTER_A						
ko	REGISTER_B						
kod	REGISTER_A						
kod	REGISTER_B						
kodar	REGISTER_A						
kodar	REGISTER_B						
kodd	REGISTER_A						
kodshe	REGISTER_A						
koees	REGISTER_A						
koiin	REGISTER_A						
kok	REGISTER_A						
kol	REGISTER_A						
kol	REGISTER_B						
kolche	REGISTER_B						
kolched	REGISTER_B						
kolchee	REGISTER_B						
kold	REGISTER_A						
kold	REGISTER_B						
kolfchd	REGISTER_B						
kolk	REGISTER_B						
kolkar	REGISTER_B						
kolot	REGISTER_A						
kolp	REGISTER_B						
kolshd	REGISTER_B						
kolshes	REGISTER_B						
kolyk	REGISTER_A						
kom	REGISTER_A						
komd	REGISTER_A						
kor	REGISTER_A						
korch	REGISTER_B						
koroiin	REGISTER_B						
korols	REGISTER_B						
kos	REGISTER_A						
koshe	REGISTER_A						
koshet	REGISTER_A						
kot	REGISTER_A						
kotal	REGISTER_B						
kotch	REGISTER_A						
kotch	REGISTER_B						
ksh	REGISTER_A						
ksh	REGISTER_B						
kshar	REGISTER_B						
kshd	REGISTER_A						
kshd	REGISTER_B						
kshe	REGISTER_A						
kshe	REGISTER_B						
kshed	REGISTER_B						
kshee	REGISTER_B						
ksheodl	REGISTER_A						
kshes	REGISTER_A						
ksho	REGISTER_A						
kshod	REGISTER_A						
kshot	REGISTER_A						
kydeed	REGISTER_B						
kyt	REGISTER_A						
l	REGISTER_A		family=F_PROC_CORE;role_group=PROC;primary_section=Recipes;struct=CL_MIXED	F_PROC_CORE	PROC	Recipes	CL_MIXED
l	REGISTER_B		family=F_PROC_CORE;role_group=PROC;primary_section=Recipes;struct=CL_MIXED	F_PROC_CORE	PROC	Recipes	CL_MIXED
l	UNKNOWN		family=F_PROC_CORE;role_group=PROC;primary_section=Recipes;struct=CL_MIXED	F_PROC_CORE	PROC	Recipes	CL_MIXED
laiiin	REGISTER_B						
lair	REGISTER_B						
lar	REGISTER_B						
laror	REGISTER_B						
las	REGISTER_B						
lch	REGISTER_A						
lch	REGISTER_B						
lchar	REGISTER_B						
lcharar	REGISTER_B						
lchckh	REGISTER_B						
lchcphed	REGISTER_B						
lchcth	REGISTER_A						
lchd	REGISTER_A						
lchd	REGISTER_B						
lche	REGISTER_A						
lche	REGISTER_B						
lchea	REGISTER_B						
lchealaim	REGISTER_B						
lchear	REGISTER_B						
lchechd	REGISTER_B						
lcheckh	REGISTER_A						
lcheckh	REGISTER_B						
lcheckhe	REGISTER_A						
lched	REGISTER_A						
lched	REGISTER_B						
lchedar	REGISTER_B						
lchedo	REGISTER_B						
lchee	REGISTER_B						
lcheed	REGISTER_B						
lcheee	REGISTER_B						
lchees	REGISTER_A						
lchees	REGISTER_B						
lcheg	REGISTER_B						
lcheo	REGISTER_A						
lcheo	REGISTER_B						
lcheod	REGISTER_B						
lcheoek	REGISTER_B						
lcheylch	REGISTER_B						
lchg	REGISTER_B						
lchl	REGISTER_A						
lchl	REGISTER_B						
lcho	REGISTER_B						
lcholk	REGISTER_B						
lchpchd	REGISTER_A						
lchr	REGISTER_B						
lchs	REGISTER_B						
lchsl	REGISTER_B						
ld	REGISTER_A						
ld	REGISTER_B						
ldaiiin	REGISTER_B						
ldal	REGISTER_B						
ldals	REGISTER_A						
ldar	REGISTER_B						
ldche	REGISTER_A						
ldo	REGISTER_B						
ldyr	REGISTER_B						
led	REGISTER_B						
leed	REGISTER_B						
leee	REGISTER_B						
leees	REGISTER_B						
leeo	REGISTER_B						
les	REGISTER_A						
lf	REGISTER_A						
lfar	REGISTER_B						
lfch	REGISTER_B						
lfchd	REGISTER_B						
lfched	REGISTER_B						
lfcheed	REGISTER_B						
lg	REGISTER_A						
lg	REGISTER_B						
lgl	REGISTER_B						
liir	REGISTER_B						
lk	REGISTER_A						
lk	REGISTER_B						
lkaiiin	REGISTER_B						
lkaiir	REGISTER_B						
lkaim	REGISTER_B						
lkair	REGISTER_B						
lkal	REGISTER_B						
lkald	REGISTER_A						
lkan	REGISTER_B						
lkar	REGISTER_A						
lkar	REGISTER_B						
lkarchees	REGISTER_B						
lkarshar	REGISTER_B						
lkch	REGISTER_B						
lkchal	REGISTER_B						
lkchd	REGISTER_B						
lkche	REGISTER_A						
lkche	REGISTER_B						
lkched	REGISTER_B						
lkcheo	REGISTER_B						
lkches	REGISTER_B						
lkchs	REGISTER_B						
lke	REGISTER_B						
lkeal	REGISTER_B						
lkech	REGISTER_B						
lkechd	REGISTER_B						
lkeche	REGISTER_B						
lkeched	REGISTER_B						
lkeches	REGISTER_B						
lked	REGISTER_B						
lkede	REGISTER_A						
lkedeed	REGISTER_B						
lkedlke	REGISTER_B						
lkedshed	REGISTER_B						
lkee	REGISTER_A						
lkee	REGISTER_B						
lkeed	REGISTER_A						
lkeed	REGISTER_B						
lkeeda	REGISTER_B						
lkeedar	REGISTER_B						
lkeede	REGISTER_B						
lkeee	REGISTER_B						
lkeeed	REGISTER_B						
lkeees	REGISTER_B						
lkeeo	REGISTER_B						
lkeeos	REGISTER_B						
lkeeshd	REGISTER_B						
lkeeshed	REGISTER_B						
lkeo	REGISTER_A						
lkeo	REGISTER_B						
lkeod	REGISTER_B						
lkeold	REGISTER_A						
lkeop	REGISTER_A						
lkeshd	REGISTER_B						
lkl	REGISTER_B						
lklche	REGISTER_B						
lkld	REGISTER_B						
lko	REGISTER_B						
lkod	REGISTER_B						
lkshe	REGISTER_B						
lkshed	REGISTER_B						
lksho	REGISTER_B						
ll	REGISTER_B						
llaiir	REGISTER_B						
llchs	REGISTER_B						
lld	REGISTER_B						
lldar	REGISTER_B						
llm	REGISTER_B						
llo	REGISTER_B						
llod	REGISTER_B						
llor	REGISTER_B						
lm	REGISTER_B						
lo	REGISTER_A						
lo	REGISTER_B						
loched	REGISTER_B						
lod	REGISTER_A						
lod	REGISTER_B						
lodar	REGISTER_B						
loed	REGISTER_B						
loee	REGISTER_A						
loee	REGISTER_B						
loeees	REGISTER_A						
loeees	REGISTER_B						
loees	REGISTER_B						
lohed	REGISTER_A						
loiiim	REGISTER_B						
loiiin	REGISTER_A						
loiin	REGISTER_B						
lok	REGISTER_B						
lokee	REGISTER_B						
lokeed	REGISTER_B						
lol	REGISTER_A						
lol	REGISTER_B						
lolch	REGISTER_A						
lold	REGISTER_B						
lolk	REGISTER_B						
lolkair	REGISTER_B						
lolke	REGISTER_B						
lolked	REGISTER_A						
lolom	REGISTER_B						
lols	REGISTER_B						
lolsaiiin	REGISTER_B						
lom	REGISTER_B						
lor	REGISTER_B						
loroin	REGISTER_B						
los	REGISTER_A						
los	REGISTER_B						
losd	REGISTER_B						
lot	REGISTER_B						
lotar	REGISTER_B						
loted	REGISTER_B						
lp	REGISTER_B						
lpaim	REGISTER_B						
lpar	REGISTER_B						
lpchd	REGISTER_A						
lpchd	REGISTER_B						
lpche	REGISTER_B						
lpched	REGISTER_B						
lpcheed	REGISTER_B						
lpchees	REGISTER_B						
lpcheo	REGISTER_B						
lpych	REGISTER_A						
lr	REGISTER_A						
lr	REGISTER_B						
lr	UNKNOWN						
lral	REGISTER_B						
ls	REGISTER_A						
ls	REGISTER_B						
lsan	REGISTER_B						
lsar	REGISTER_B						
lsh	REGISTER_A						
lsh	REGISTER_B						
lshalsh	REGISTER_B						
lshckh	REGISTER_A						
lshcth	REGISTER_B						
lshd	REGISTER_A						
lshd	REGISTER_B						
lshdar	REGISTER_B						
lshdyqo	REGISTER_A						
lshe	REGISTER_B						
lsheckh	REGISTER_A						
lsheckh	REGISTER_B						
lsheckhed	REGISTER_B						
lshed	REGISTER_A						
lshed	REGISTER_B						
lshee	REGISTER_B						
lsheed	REGISTER_B						
lshees	REGISTER_B						
lsheet	REGISTER_B						
lsheg	REGISTER_B						
lshek	REGISTER_B						
lsheok	REGISTER_B						
lshet	REGISTER_A						
lshet	REGISTER_B						
lshl	REGISTER_A						
lt	REGISTER_B						
ltal	REGISTER_B						
ltar	REGISTER_A						
ltar	REGISTER_B						
ltchd	REGISTER_B						
ltche	REGISTER_A						
ltchs	REGISTER_B						
lte	REGISTER_B						
lted	REGISTER_A						
lted	REGISTER_B						
ltee	REGISTER_B						
lteed	REGISTER_B						
ltshol	REGISTER_B						
lx	REGISTER_B						
m	REGISTER_A						
m	REGISTER_B						
mar	REGISTER_A						
n	REGISTER_A						
o	REGISTER_A		family=F_BOTANICAL_CORE;role_group=BOT;primary_section=Herbal;struct=CL_MIXED	F_BOTANICAL_CORE	BOT	Herbal	CL_MIXED
o	REGISTER_B		family=F_BOTANICAL_CORE;role_group=BOT;primary_section=Herbal;struct=CL_MIXED	F_BOTANICAL_CORE	BOT	Herbal	CL_MIXED
oafoal	REGISTER_A						
oaiir	REGISTER_A						
oaiir	REGISTER_B						
oair	REGISTER_B						
oaldar	REGISTER_B						
oamr	REGISTER_B						
oar	REGISTER_A						
oar	REGISTER_B						
ocfhd	REGISTER_B						
ocfhe	UNKNOWN						
ocfhh	REGISTER_A						
och	REGISTER_A						
och	REGISTER_B						
ochal	REGISTER_B						
ochar	REGISTER_A						
ochar	REGISTER_B						
ochd	REGISTER_A						
oche	REGISTER_B						
oched	REGISTER_B						
ochedar	REGISTER_A						
ochee	REGISTER_B						
ocheed	REGISTER_B						
ocheek	REGISTER_A						
ochek	REGISTER_A						
ochepal	REGISTER_A						
ochold	REGISTER_A						
ochos	REGISTER_B						
ochs	REGISTER_B						
ockh	REGISTER_A						
ockh	REGISTER_B						
ockhe	REGISTER_A						
ockhe	REGISTER_B						
ockhed	REGISTER_B						
ockhee	REGISTER_A						
ockhh	REGISTER_A						
ockhh	REGISTER_B						
ockhodar	REGISTER_B						
ocko	REGISTER_A						
ocph	REGISTER_A						
ocph	REGISTER_B						
ocphe	REGISTER_B						
ocphed	REGISTER_B						
ocphor	REGISTER_A						
oct	REGISTER_A						
octh	REGISTER_A						
octh	REGISTER_B						
octhair	REGISTER_B						
octhch	REGISTER_A						
octhd	REGISTER_B						
octhe	REGISTER_B						
octhed	REGISTER_B						
octhodal	REGISTER_A						
octhole	REGISTER_B						
octhos	REGISTER_A						
od	REGISTER_A						
od	REGISTER_B						
od	UNKNOWN						
odaid	REGISTER_B						
odaiiil	REGISTER_A						
odaiiin	REGISTER_B						
odaiir	REGISTER_A						
odaiir	UNKNOWN						
odair	REGISTER_A						
odair	REGISTER_B						
odal	REGISTER_B						
odalal	REGISTER_B						
odald	REGISTER_A						
odan	REGISTER_A						
odar	REGISTER_A						
odar	REGISTER_B						
odariin	REGISTER_A						
odchees	REGISTER_A						
ode	REGISTER_A						
ode	REGISTER_B						
odee	REGISTER_B						
odeed	REGISTER_A						
odeed	REGISTER_B						
odeee	REGISTER_B						
odeeee	REGISTER_B						
odl	REGISTER_B						
odr	REGISTER_B						
odreee	REGISTER_B						
ods	REGISTER_A						
odshe	REGISTER_A						
ody	REGISTER_A						
ody	REGISTER_B						
odyd	REGISTER_A						
odys	REGISTER_B						
oe	REGISTER_B						
oeail	REGISTER_B						
oeched	REGISTER_B						
oed	REGISTER_B						
oedair	REGISTER_B						
oee	REGISTER_A						
oee	REGISTER_B						
oeear	REGISTER_A						
oeear	REGISTER_B						
oeecth	REGISTER_A						
oeed	REGISTER_B						
oeee	REGISTER_B						
oeeed	REGISTER_A						
oeeek	REGISTER_B						
oeeeo	REGISTER_A						
oeeeodr	REGISTER_B						
oeeeos	REGISTER_B						
oeees	REGISTER_A						
oeees	REGISTER_B						
oeeo	REGISTER_A						
oeeockh	REGISTER_A						
oeeos	REGISTER_B						
oees	REGISTER_A						
oees	REGISTER_B						
oeesear	REGISTER_B						
oek	REGISTER_A						
oek	REGISTER_B						
oeka	REGISTER_B						
oekchd	REGISTER_A						
oeke	REGISTER_B						
oekee	REGISTER_B						
oekeed	REGISTER_B						
oekes	REGISTER_B						
oeksh	REGISTER_B						
oeoikh	REGISTER_B						
oeoldan	REGISTER_B						
oepch	REGISTER_B						
oepchkshee	REGISTER_A						
oes	REGISTER_B						
oesearees	REGISTER_A						
oetalchg	REGISTER_B						
oetchd	REGISTER_B						
oete	REGISTER_A						
oeteos	REGISTER_B						
of	REGISTER_A						
of	REGISTER_B						
ofad	REGISTER_B						
ofaiino	REGISTER_B						
ofaiis	REGISTER_B						
ofar	REGISTER_B						
ofaramot	REGISTER_B						
ofch	REGISTER_A						
ofch	REGISTER_B						
ofchar	REGISTER_A						
ofchd	REGISTER_A						
ofchd	REGISTER_B						
ofche	REGISTER_A						
ofche	REGISTER_B						
ofched	REGISTER_A						
ofched	REGISTER_B						
ofchedaiis	REGISTER_B						
ofcheds	REGISTER_B						
ofcho	REGISTER_B						
ofchor	REGISTER_A						
ofchr	REGISTER_B						
ofchtar	REGISTER_A						
ofol	REGISTER_A						
ofor	REGISTER_B						
ofshd	REGISTER_A						
ofyche	REGISTER_A						
ogom	REGISTER_B						
oh	REGISTER_B						
ohe	REGISTER_B						
oheekar	REGISTER_A						
oifhed	REGISTER_A						
oiiiin	REGISTER_B						
oiiin	REGISTER_A						
oiiin	REGISTER_B						
oiin	REGISTER_A						
oiin	REGISTER_B						
oiir	REGISTER_A						
oiir	REGISTER_B						
oikh	REGISTER_B						
oin	REGISTER_B						
oinal	REGISTER_B						
oinysarx	REGISTER_B						
oir	REGISTER_A						
oir	REGISTER_B						
oith	REGISTER_B						
ok	REGISTER_A						
ok	REGISTER_B						
oka	REGISTER_A						
oka	UNKNOWN						
okache	REGISTER_A						
okad	REGISTER_A						
okad	UNKNOWN						
okaeeche	REGISTER_B						
okag	REGISTER_A						
okai	REGISTER_A						
okai	REGISTER_B						
okaifh	REGISTER_B						
okaifhh	REGISTER_B						
okaiifch	REGISTER_B						
okaiiin	REGISTER_B						
okaiikh	REGISTER_A						
okaiir	REGISTER_A						
okaiir	REGISTER_B						
okaiis	REGISTER_B						
okaikal	REGISTER_B						
okail	REGISTER_B						
okaild	REGISTER_B						
okaim	REGISTER_B						
okain	REGISTER_B		family=F_PROC_CORE;role_group=PROC;primary_section=Recipes;struct=CL_PROC_RIGHT	F_PROC_CORE	PROC	Recipes	CL_PROC_RIGHT
okair	REGISTER_A						
okair	REGISTER_B						
okairo	REGISTER_B						
okais	REGISTER_A						
okal	REGISTER_A						
okal	REGISTER_B						
okalar	REGISTER_B						
okalch	REGISTER_B						
okalchd	REGISTER_B						
okalched	REGISTER_B						
okalcheg	REGISTER_A						
okald	REGISTER_A						
okald	REGISTER_B						
okalda	REGISTER_A						
okalshd	REGISTER_B						
okalshe	REGISTER_B						
okalys	REGISTER_B						
okan	REGISTER_A						
okan	REGISTER_B						
okaos	REGISTER_B						
okar	REGISTER_A		family=F_PROC_CORE;role_group=PROC;primary_section=Recipes;struct=CL_PROC_RIGHT	F_PROC_CORE	PROC	Recipes	CL_PROC_RIGHT
okar	REGISTER_B		family=F_PROC_CORE;role_group=PROC;primary_section=Recipes;struct=CL_PROC_RIGHT	F_PROC_CORE	PROC	Recipes	CL_PROC_RIGHT
okaral	REGISTER_B						
okard	UNKNOWN						
okas	REGISTER_A						
okas	REGISTER_B						
okch	REGISTER_A						
okch	REGISTER_B						
okchan	REGISTER_A						
okchar	REGISTER_A						
okchar	REGISTER_B						
okchd	REGISTER_A						
okchd	REGISTER_B						
okchdar	REGISTER_B						
okchdpch	REGISTER_B						
okche	REGISTER_A						
okche	REGISTER_B						
okched	REGISTER_A						
okched	REGISTER_B						
okchedyl	REGISTER_B						
okchee	REGISTER_A						
okchee	REGISTER_B						
okcheef	REGISTER_B						
okcheeg	REGISTER_A						
okcheeo	REGISTER_B						
okcheo	REGISTER_B						
okcheod	REGISTER_A						
okches	REGISTER_B						
okchh	REGISTER_B						
okcho	REGISTER_A						
okcho	REGISTER_B						
okcho	UNKNOWN						
okchod	REGISTER_A						
okchoda	REGISTER_B						
okchodsh	REGISTER_A						
okchoiiin	REGISTER_B						
okchom	REGISTER_A						
okchos	REGISTER_B						
okchoteees	REGISTER_B						
okchyd	REGISTER_A						
okd	REGISTER_B						
oke	REGISTER_A						
oke	REGISTER_B						
oke	UNKNOWN						
okeal	REGISTER_B						
okear	REGISTER_A						
okear	REGISTER_B						
okearche	REGISTER_A						
okech	REGISTER_A						
okech	REGISTER_B						
okechd	REGISTER_A						
okechd	REGISTER_B						
okechea	UNKNOWN						
okeched	REGISTER_B						
okechee	REGISTER_B						
okechl	UNKNOWN						
okecho	REGISTER_A						
okechoked	REGISTER_B						
okechol	REGISTER_B						
okechs	REGISTER_B						
oked	REGISTER_A						
oked	REGISTER_B						
oked	UNKNOWN						
okedal	REGISTER_B						
okedals	REGISTER_B						
okedar	REGISTER_A						
okedar	REGISTER_B						
okedyd	REGISTER_B						
okedyted	REGISTER_B						
okee	REGISTER_A						
okee	REGISTER_B						
okee	UNKNOWN						
okeea	REGISTER_B						
okeear	REGISTER_A						
okeear	REGISTER_B						
okeeas	REGISTER_B						
okeech	REGISTER_B						
okeed	REGISTER_A						
okeed	REGISTER_B						
okeed	UNKNOWN						
okeedaim	REGISTER_B						
okeedak	REGISTER_B						
okeedal	REGISTER_A						
okeedal	UNKNOWN						
okeedar	REGISTER_B						
okeeddl	REGISTER_B						
okeede	REGISTER_B						
okeee	REGISTER_A						
okeee	REGISTER_B						
okeee	UNKNOWN						
okeeed	REGISTER_B						
okeeel	REGISTER_B						
okeeeo	REGISTER_B						
okeeeos	REGISTER_B						
okeees	REGISTER_B						
okeeese	REGISTER_B						
okeeeykch	REGISTER_B						
okeeg	REGISTER_A						
okeeo	REGISTER_A						
okeeo	REGISTER_B						
okeeod	REGISTER_B						
okeeoda	REGISTER_A						
okeeol	REGISTER_B						
okeeolkchee	REGISTER_B						
okeeom	REGISTER_B						
okeeos	REGISTER_A						
okeeos	REGISTER_B						
okeer	REGISTER_A						
okees	REGISTER_A						
okees	REGISTER_B						
okeesh	REGISTER_B						
okeesodar	REGISTER_B						
okeeylched	REGISTER_B						
okeeyteed	REGISTER_B						
okehd	REGISTER_A						
okem	REGISTER_A						
okeo	REGISTER_A						
okeo	REGISTER_B						
okeockhe	REGISTER_B						
okeod	REGISTER_A						
okeod	REGISTER_B						
okeodal	REGISTER_B						
okeodar	REGISTER_B						
okeodl	REGISTER_B						
okeoeee	REGISTER_A						
okeoek	UNKNOWN						
okeohdar	REGISTER_A						
okeok	REGISTER_B						
okeokedr	REGISTER_A						
okeokeoke	REGISTER_B						
okeol	REGISTER_A		family=F_PROC_CORE;role_group=PROC;primary_section=Pharmaceutical;struct=CL_MIXED	F_PROC_CORE	PROC	Pharmaceutical	CL_MIXED
okeol	REGISTER_B		family=F_PROC_CORE;role_group=PROC;primary_section=Pharmaceutical;struct=CL_MIXED	F_PROC_CORE	PROC	Pharmaceutical	CL_MIXED
okeolan	REGISTER_B						
okeold	REGISTER_A						
okeolke	REGISTER_B						
okeols	REGISTER_B						
okeolshe	REGISTER_B						
okeom	REGISTER_A						
okeom	REGISTER_B						
okeorl	REGISTER_B						
okeos	REGISTER_A						
okeos	REGISTER_B						
okeos	UNKNOWN						
okeosar	REGISTER_A						
okeosar	REGISTER_B						
okeoschso	REGISTER_A						
okeotee	REGISTER_B						
okes	REGISTER_A						
okes	REGISTER_B						
okesh	REGISTER_A						
okesh	REGISTER_B						
okeshed	REGISTER_B						
okeshos	REGISTER_B						
okesoe	REGISTER_A						
okeyr	REGISTER_B						
okeyt	REGISTER_B						
okeytee	REGISTER_A						
okhar	REGISTER_B						
okiin	REGISTER_B						
okilche	REGISTER_B						
okinaiir	REGISTER_B						
okirolc	REGISTER_B						
okl	REGISTER_B						
oko	REGISTER_A						
oko	REGISTER_B						
okoche	REGISTER_B						
okod	REGISTER_A						
okod	REGISTER_B						
okodar	REGISTER_A						
okodee	REGISTER_B						
okoe	REGISTER_B						
okoee	REGISTER_B						
okoiin	REGISTER_A						
okoiin	REGISTER_B						
okokch	REGISTER_A						
okokom	REGISTER_A						
okoksheo	REGISTER_B						
okol	REGISTER_A						
okol	REGISTER_B						
okolair	REGISTER_A						
okolarm	REGISTER_A						
okolch	REGISTER_B						
okolche	REGISTER_A						
okolche	REGISTER_B						
okold	REGISTER_A						
okold	REGISTER_B						
okoldal	REGISTER_A						
okoldm	REGISTER_B						
okoleeolar	UNKNOWN						
okolr	REGISTER_B						
okols	REGISTER_A						
okolsh	REGISTER_B						
okom	REGISTER_A						
okom	REGISTER_B						
okorair	REGISTER_B						
okos	REGISTER_A						
okos	REGISTER_B						
okr	REGISTER_B						
oksed	REGISTER_B						
okseo	REGISTER_A						
oksh	REGISTER_A						
oksh	REGISTER_B						
okshched	REGISTER_B						
okshd	REGISTER_B						
okshe	REGISTER_A						
okshe	REGISTER_B						
okshed	REGISTER_A						
okshed	REGISTER_B						
okshee	REGISTER_B						
oksheo	REGISTER_A						
oksho	REGISTER_A						
oksholsh	REGISTER_A						
okyd	REGISTER_B						
okyl	REGISTER_B						
okyld	REGISTER_B						
okylk	REGISTER_A						
ol	REGISTER_A		family=F_BIO_CORE;role_group=BIO;primary_section=Biological;struct=CL_BIO	F_BIO_CORE	BIO	Biological	CL_BIO
ol	REGISTER_B		family=F_BIO_CORE;role_group=BIO;primary_section=Biological;struct=CL_BIO	F_BIO_CORE	BIO	Biological	CL_BIO
ol	UNKNOWN		family=F_BIO_CORE;role_group=BIO;primary_section=Biological;struct=CL_BIO	F_BIO_CORE	BIO	Biological	CL_BIO
ola	REGISTER_B						
olaiiin	REGISTER_B						
olaiin	REGISTER_B						
olaiir	REGISTER_A						
olaiir	REGISTER_B						
olaikh	REGISTER_B						
olain	REGISTER_B						
olair	REGISTER_B						
olal	REGISTER_B						
olald	REGISTER_A						
olald	REGISTER_B						
olan	REGISTER_B						
olar	REGISTER_A						
olar	REGISTER_B						
olaral	REGISTER_B						
olch	REGISTER_A						
olch	REGISTER_B						
olcha	REGISTER_A						
olchad	REGISTER_A						
olchar	REGISTER_A						
olchcth	REGISTER_A						
olchd	REGISTER_A						
olchd	REGISTER_B						
olchdar	REGISTER_B						
olche	REGISTER_A						
olche	REGISTER_B						
olchear	REGISTER_B						
olcheckh	REGISTER_B						
olched	REGISTER_A						
olched	REGISTER_B						
olched	UNKNOWN						
olchedr	REGISTER_B						
olchedyo	REGISTER_B						
olchee	REGISTER_A						
olchee	REGISTER_B						
olcheed	REGISTER_B						
olcheem	REGISTER_B						
olchees	REGISTER_B						
olcheet	REGISTER_A						
olchef	REGISTER_B						
olchek	REGISTER_B						
olches	REGISTER_B						
olchocfh	REGISTER_B						
olchod	REGISTER_A						
olchok	REGISTER_B						
olcph	REGISTER_A						
olcsed	REGISTER_A						
old	REGISTER_A						
old	REGISTER_B						
old	UNKNOWN						
oldar	REGISTER_A						
oldar	REGISTER_B						
oldckh	REGISTER_A						
olee	REGISTER_B						
oleeal	REGISTER_B						
oleed	REGISTER_B						
oleee	REGISTER_B						
oleeed	REGISTER_B						
oleees	REGISTER_A						
oleees	REGISTER_B						
oleeo	UNKNOWN						
oleese	REGISTER_B						
olek	REGISTER_A						
olekar	REGISTER_B						
olekee	REGISTER_A						
olf	REGISTER_B						
olfar	REGISTER_B						
olfch	REGISTER_A						
olfch	REGISTER_B						
olfche	REGISTER_B						
olfched	REGISTER_A						
olfched	REGISTER_B						
olk	REGISTER_A						
olk	REGISTER_B						
olkad	REGISTER_B						
olkaiir	REGISTER_B						
olkair	REGISTER_B						
olkais	REGISTER_B						
olkal	REGISTER_B						
olkao	REGISTER_A						
olkar	REGISTER_A						
olkar	REGISTER_B						
olkard	REGISTER_A						
olkch	REGISTER_A						
olkch	REGISTER_B						
olkchd	REGISTER_B						
olkche	REGISTER_B						
olkched	REGISTER_B						
olkcho	REGISTER_B						
olke	REGISTER_A						
olke	REGISTER_B						
olkech	REGISTER_B						
olked	REGISTER_A						
olked	REGISTER_B						
olkee	REGISTER_A						
olkee	REGISTER_B						
olkeear	REGISTER_B						
olkeech	REGISTER_B						
olkeechd	REGISTER_B						
olkeeche	REGISTER_B						
olkeed	REGISTER_A						
olkeed	REGISTER_B						
olkeee	REGISTER_B						
olkeeear	REGISTER_B						
olkeeed	REGISTER_B						
olkeees	REGISTER_B						
olkeeo	REGISTER_A						
olkeeo	REGISTER_B						
olkeeod	REGISTER_B						
olkeeol	REGISTER_A						
olkees	REGISTER_B						
olkeeycth	REGISTER_A						
olkeeyr	REGISTER_B						
olkeshar	REGISTER_B						
olkeshe	REGISTER_A						
olkiir	REGISTER_B						
olkl	REGISTER_B						
olkor	REGISTER_B						
olkshd	REGISTER_A						
olkshe	REGISTER_B						
olkshed	REGISTER_B						
oll	REGISTER_B						
ollch	REGISTER_B						
olld	REGISTER_B						
olo	REGISTER_A						
olo	REGISTER_B						
oloeeed	REGISTER_B						
oloeor	REGISTER_B						
oloesdr	REGISTER_B						
oloiin	REGISTER_A						
oloiin	REGISTER_B						
oloiir	REGISTER_A						
olok	REGISTER_B						
olokar	REGISTER_A						
olold	REGISTER_A						
olold	REGISTER_B						
olom	REGISTER_A						
olom	REGISTER_B						
olor	REGISTER_B						
olord	REGISTER_B						
olos	REGISTER_B						
olotched	REGISTER_B						
olpair	REGISTER_B						
olpche	REGISTER_A						
olpche	REGISTER_B						
olpched	REGISTER_A						
olpched	REGISTER_B						
olpchee	REGISTER_B						
olpchesd	REGISTER_B						
olpoikh	REGISTER_B						
olpsh	REGISTER_B						
olpshed	REGISTER_B						
olqo	REGISTER_B						
olr	REGISTER_B						
ols	REGISTER_A						
ols	REGISTER_B						
olsar	REGISTER_A						
olsar	REGISTER_B						
olse	REGISTER_A						
olseeg	REGISTER_B						
olsh	REGISTER_A						
olsh	REGISTER_B						
olshals	REGISTER_B						
olshd	REGISTER_A						
olshd	REGISTER_B						
olshe	REGISTER_A						
olshe	REGISTER_B						
olshed	REGISTER_A						
olshed	REGISTER_B						
olshee	REGISTER_A						
olshee	REGISTER_B						
olsheeos	REGISTER_A						
olshl	REGISTER_A						
olsho	REGISTER_A						
olsht	REGISTER_A						
olt	REGISTER_A						
olt	REGISTER_B						
oltar	REGISTER_A						
oltar	REGISTER_B						
oltch	REGISTER_A						
oltch	REGISTER_B						
oltchd	REGISTER_B						
oltche	REGISTER_B						
oltchee	REGISTER_B						
olte	REGISTER_B						
olted	REGISTER_A						
olted	REGISTER_B						
oltee	REGISTER_B						
olteed	REGISTER_B						
olteeed	REGISTER_B						
oltshe	REGISTER_A						
oltshe	REGISTER_B						
oltshed	REGISTER_B						
oltyd	REGISTER_B						
olyt	REGISTER_A						
om	REGISTER_A						
om	REGISTER_B						
ook	REGISTER_B						
oolals	REGISTER_B						
ools	REGISTER_B						
op	REGISTER_A						
op	REGISTER_B						
opa	REGISTER_B						
opaich	REGISTER_B						
opaiim	REGISTER_B						
opaiir	REGISTER_B						
opaiis	REGISTER_B						
opail	REGISTER_B						
opailo	REGISTER_B						
opaim	REGISTER_B						
opair	REGISTER_B						
opairal	REGISTER_B						
opak	REGISTER_B						
opal	REGISTER_B						
opalchd	REGISTER_B						
opald	REGISTER_B						
opalefom	REGISTER_A						
opalk	REGISTER_A						
opalk	REGISTER_B						
opalkar	REGISTER_B						
opalshed	REGISTER_B						
opar	REGISTER_A						
opar	REGISTER_B						
opas	REGISTER_B						
opch	REGISTER_A						
opch	REGISTER_B						
opchal	REGISTER_B						
opchald	REGISTER_A						
opchar	REGISTER_A						
opchar	REGISTER_B						
opchd	REGISTER_A						
opchd	REGISTER_B						
opchdar	REGISTER_B						
opche	REGISTER_A						
opche	REGISTER_B						
opcheal	REGISTER_B						
opchear	REGISTER_A						
opchear	REGISTER_B						
opcheas	REGISTER_A						
opched	REGISTER_A						
opched	REGISTER_B						
opcheddl	REGISTER_B						
opchee	REGISTER_B						
opchee	UNKNOWN						
opcheear	REGISTER_B						
opcheed	REGISTER_B						
opcheek	REGISTER_B						
opcheeo	REGISTER_B						
opchees	REGISTER_B						
opchek	REGISTER_A						
opchekan	REGISTER_B						
opcheo	REGISTER_B						
opcheocf	REGISTER_B						
opcheodair	REGISTER_B						
opcheolf	REGISTER_B						
opchep	REGISTER_B						
opches	REGISTER_B						
opchet	REGISTER_B						
opcho	REGISTER_B						
opchod	REGISTER_A						
opchol	REGISTER_A						
opchol	REGISTER_B						
opcholal	REGISTER_B						
opchsd	REGISTER_B						
opchse	REGISTER_B						
opcsed	REGISTER_B						
opd	REGISTER_B						
opdaildo	REGISTER_B						
opdair	REGISTER_B						
opdarshd	REGISTER_A						
ophee	REGISTER_B						
opod	REGISTER_A						
opoees	REGISTER_B						
opoiin	REGISTER_B						
opol	REGISTER_A						
opol	REGISTER_B						
opolkod	REGISTER_A						
opoloiin	REGISTER_B						
opols	REGISTER_A						
opom	REGISTER_A						
opor	REGISTER_A						
opor	REGISTER_B						
opote	REGISTER_B						
opsh	REGISTER_A						
opsh	REGISTER_B						
opshd	REGISTER_B						
opshe	REGISTER_B						
opshed	REGISTER_A						
opshed	REGISTER_B						
opsheol	REGISTER_B						
opsheyte	REGISTER_B						
opsho	REGISTER_B						
opshol	REGISTER_B						
opy	REGISTER_A						
opyd	REGISTER_A						
opyd	REGISTER_B						
opyke	REGISTER_A						
oq	REGISTER_A						
oq	REGISTER_B						
oqo	REGISTER_B						
oqockh	REGISTER_B						
oqofched	REGISTER_A						
oqok	REGISTER_A						
oqokar	REGISTER_B						
oqokee	REGISTER_B						
oqot	REGISTER_B						
or	REGISTER_A						
or	REGISTER_B						
or	UNKNOWN						
oracph	REGISTER_A						
orai	REGISTER_A						
oraiiin	REGISTER_A						
oraiiin	REGISTER_B						
orair	REGISTER_A						
orair	REGISTER_B						
oralar	REGISTER_A						
orar	REGISTER_A						
orar	REGISTER_B						
oraroeke	REGISTER_A						
orarorch	REGISTER_B						
oraryteop	REGISTER_B						
orch	REGISTER_A						
orchcth	REGISTER_B						
orchcthd	REGISTER_B						
orche	REGISTER_A						
orche	REGISTER_B						
orched	REGISTER_B						
orchedar	REGISTER_B						
orchee	REGISTER_B						
orcheor	REGISTER_B						
ord	REGISTER_A						
ord	REGISTER_B						
ore	REGISTER_B						
oreeem	REGISTER_B						
oreso	REGISTER_A						
org	REGISTER_B						
oriid	REGISTER_A						
oriim	REGISTER_B						
oriin	REGISTER_A						
ork	REGISTER_B						
orkar	REGISTER_B						
orkchd	REGISTER_B						
orkchsd	REGISTER_B						
orkeee	REGISTER_A						
oro	REGISTER_A						
oro	REGISTER_B						
orod	REGISTER_B						
oroiir	REGISTER_B						
oroir	REGISTER_A						
orokeeee	REGISTER_B						
orol	REGISTER_A						
orol	REGISTER_B						
orold	REGISTER_B						
orolg	REGISTER_A						
orolk	REGISTER_B						
orolod	REGISTER_A						
orom	REGISTER_A						
orom	REGISTER_B						
ors	REGISTER_B						
orsh	REGISTER_A						
orsheckh	REGISTER_B						
orsheed	REGISTER_B						
orsheeen	REGISTER_B						
orshos	REGISTER_A						
os	REGISTER_A						
os	REGISTER_B						
osaiiin	REGISTER_B						
osal	REGISTER_A						
osar	REGISTER_B						
osch	REGISTER_A						
osch	REGISTER_B						
oscho	REGISTER_A						
oseeedar	REGISTER_B						
oshche	REGISTER_B						
oshd	REGISTER_B						
oshe	REGISTER_A						
oshe	REGISTER_B						
oshed	REGISTER_B						
osheek	REGISTER_B						
oshepols	REGISTER_B						
oshox	REGISTER_B						
oshyteed	REGISTER_A						
osos	REGISTER_A						
ot	REGISTER_A						
ot	REGISTER_B						
ot	UNKNOWN						
ota	REGISTER_A						
ota	REGISTER_B						
otadar	REGISTER_B						
otaiiin	REGISTER_A						
otaiik	REGISTER_B						
otaiil	REGISTER_B						
otaiir	REGISTER_A						
otaiir	REGISTER_B						
otail	REGISTER_B						
otaim	REGISTER_B						
otainos	REGISTER_B						
otaipch	REGISTER_B						
otair	REGISTER_A						
otair	REGISTER_B						
otairar	REGISTER_B						
otairin	REGISTER_A						
otais	REGISTER_B						
otak	REGISTER_B						
otakar	REGISTER_B						
otake	REGISTER_B						
otal	REGISTER_A		family=F_PROC_CORE;role_group=PROC;primary_section=Recipes;struct=CL_PROC_RIGHT	F_PROC_CORE	PROC	Recipes	CL_PROC_RIGHT
otal	REGISTER_B		family=F_PROC_CORE;role_group=PROC;primary_section=Recipes;struct=CL_PROC_RIGHT	F_PROC_CORE	PROC	Recipes	CL_PROC_RIGHT
otalair	REGISTER_B						
otalar	REGISTER_B						
otalch	REGISTER_B						
otald	REGISTER_A						
otald	REGISTER_B						
otaldiin	REGISTER_A						
otalk	REGISTER_B						
otalkch	REGISTER_B						
otalod	REGISTER_B						
otalr	REGISTER_B						
otals	REGISTER_B						
otalshd	REGISTER_B						
otalshed	REGISTER_B						
otan	REGISTER_A						
otan	REGISTER_B						
otar	REGISTER_A		family=F_PROC_CORE;role_group=PROC;primary_section=Recipes;struct=CL_PROC_RIGHT	F_PROC_CORE	PROC	Recipes	CL_PROC_RIGHT
otar	REGISTER_B		family=F_PROC_CORE;role_group=PROC;primary_section=Recipes;struct=CL_PROC_RIGHT	F_PROC_CORE	PROC	Recipes	CL_PROC_RIGHT
otara	REGISTER_B						
otarar	REGISTER_B						
otaras	REGISTER_B						
otarch	REGISTER_B						
otard	REGISTER_B						
otariin	REGISTER_A						
otariin	REGISTER_B						
otaryl	REGISTER_B						
otas	REGISTER_B						
otch	REGISTER_A						
otch	REGISTER_B						
otch	UNKNOWN						
otchald	REGISTER_A						
otchar	REGISTER_A						
otchar	REGISTER_B						
otchd	REGISTER_A						
otchd	REGISTER_B						
otchdo	REGISTER_B						
otche	REGISTER_A						
otche	REGISTER_B						
otchech	REGISTER_B						
otched	REGISTER_A						
otched	REGISTER_B						
otchedair	REGISTER_B						
otchedar	REGISTER_B						
otchede	REGISTER_B						
otchee	REGISTER_A						
otchee	REGISTER_B						
otcheed	REGISTER_B						
otcheeo	REGISTER_B						
otcheod	REGISTER_B						
otcheol	REGISTER_A						
otcheolom	REGISTER_A						
otcheos	REGISTER_B						
otches	REGISTER_B						
otchetchar	REGISTER_A						
otcheypched	REGISTER_B						
otchl	UNKNOWN						
otchm	REGISTER_A						
otcho	REGISTER_A						
otcho	REGISTER_B						
otchod	REGISTER_A						
otchod	REGISTER_B						
otchodar	REGISTER_B						
otchok	REGISTER_A						
otchos	REGISTER_A						
otchos	REGISTER_B						
otchosh	REGISTER_A						
otchot	REGISTER_B						
otchr	REGISTER_B						
otchs	UNKNOWN						
otchsd	REGISTER_B						
otd	REGISTER_B						
otdad	REGISTER_B						
ote	REGISTER_A						
ote	REGISTER_B						
ote	UNKNOWN						
otealched	REGISTER_B						
otear	REGISTER_B						
oteas	REGISTER_B						
otech	REGISTER_A						
otech	REGISTER_B						
otech	UNKNOWN						
otechd	REGISTER_B						
otecheed	REGISTER_B						
otecheo	REGISTER_B						
otechg	REGISTER_A						
otechs	REGISTER_A						
otechsh	REGISTER_B						
otechys	REGISTER_B						
oted	REGISTER_A						
oted	REGISTER_B						
otedair	REGISTER_B						
otedal	REGISTER_B						
otedar	REGISTER_A						
otedar	REGISTER_B						
otedar	UNKNOWN						
otedas	REGISTER_B						
otedee	REGISTER_B						
otedos	REGISTER_B						
otedyl	REGISTER_B						
otedyo	REGISTER_B						
otee	REGISTER_A						
otee	REGISTER_B						
oteech	REGISTER_B						
oteed	REGISTER_A						
oteed	REGISTER_B						
oteedan	REGISTER_B						
oteedar	REGISTER_B						
oteee	REGISTER_B						
oteeed	REGISTER_B						
oteeedche	REGISTER_B						
oteeen	REGISTER_A						
oteeeo	REGISTER_B						
oteeeodar	REGISTER_B						
oteees	REGISTER_A						
oteees	REGISTER_B						
oteeg	REGISTER_B						
oteem	REGISTER_A						
oteeo	REGISTER_A						
oteeo	REGISTER_B						
oteeoal	REGISTER_A						
oteeoal	REGISTER_B						
oteeod	REGISTER_A						
oteeod	REGISTER_B						
oteeodail	REGISTER_B						
oteeodals	REGISTER_A						
oteeodar	REGISTER_A						
oteeodl	REGISTER_B						
oteeol	UNKNOWN						
oteeolch	REGISTER_B						
oteeolkee	REGISTER_B						
oteeos	REGISTER_A						
oteeos	REGISTER_B						
otees	REGISTER_A						
otees	REGISTER_B						
oteeshs	REGISTER_A						
oteeyke	REGISTER_B						
oteeyksh	REGISTER_B						
oteeys	REGISTER_A						
oteo	REGISTER_A						
oteo	REGISTER_B						
oteoarar	REGISTER_A						
oteoch	REGISTER_B						
oteoche	REGISTER_B						
oteoched	REGISTER_A						
oteod	REGISTER_A						
oteod	REGISTER_B						
oteod	UNKNOWN						
oteodair	REGISTER_B						
oteodar	REGISTER_A						
oteodar	REGISTER_B						
oteodch	REGISTER_B						
oteodched	REGISTER_B						
oteodl	REGISTER_B						
oteodo	REGISTER_B						
oteodshe	REGISTER_A						
oteoee	REGISTER_B						
oteoef	REGISTER_B						
oteoin	REGISTER_B						
oteokee	REGISTER_B						
oteol	REGISTER_B						
oteolair	REGISTER_B						
oteold	REGISTER_B						
oteom	REGISTER_A						
oteom	REGISTER_B						
oteoos	REGISTER_B						
oteor	REGISTER_B						
oteorar	REGISTER_B						
oteorom	REGISTER_B						
oteos	REGISTER_A						
oteos	REGISTER_B						
oteos	UNKNOWN						
oteosd	REGISTER_B						
oteoshe	REGISTER_B						
oteote	REGISTER_A						
oteote	REGISTER_B						
oteotee	REGISTER_B						
oteoteotsho	REGISTER_B						
otes	REGISTER_A						
otes	REGISTER_B						
otesalod	REGISTER_B						
oteyd	REGISTER_A						
oteys	REGISTER_B						
otgoldl	REGISTER_B						
otiiin	REGISTER_B						
otiir	REGISTER_B						
otkched	REGISTER_B						
otl	REGISTER_B						
otlchd	REGISTER_B						
oto	REGISTER_A						
oto	REGISTER_B						
otoar	REGISTER_A						
otocs	REGISTER_B						
otod	REGISTER_A						
otod	REGISTER_B						
otodar	REGISTER_A						
otodar	REGISTER_B						
otodeeeo	REGISTER_B						
otoees	REGISTER_B						
otoeese	REGISTER_A						
otoiin	REGISTER_A						
otoiin	REGISTER_B						
otok	REGISTER_B						
otokche	REGISTER_A						
otokcho	REGISTER_B						
otokeed	REGISTER_B						
otokeedar	REGISTER_A						
otokeoar	REGISTER_B						
otol	REGISTER_A		family=F_BOTANICAL_CORE;role_group=BOT;primary_section=Herbal;struct=CL_MIXED	F_BOTANICAL_CORE	BOT	Herbal	CL_MIXED
otol	REGISTER_B		family=F_BOTANICAL_CORE;role_group=BOT;primary_section=Herbal;struct=CL_MIXED	F_BOTANICAL_CORE	BOT	Herbal	CL_MIXED
otol	UNKNOWN		family=F_BOTANICAL_CORE;role_group=BOT;primary_section=Herbal;struct=CL_MIXED	F_BOTANICAL_CORE	BOT	Herbal	CL_MIXED
otolches	REGISTER_B						
otold	REGISTER_A						
otold	REGISTER_B						
otoldyl	REGISTER_B						
otolo	REGISTER_A						
otolod	REGISTER_A						
otololees	REGISTER_A						
otolop	REGISTER_B						
otoloshee	REGISTER_A						
otolot	REGISTER_B						
otolsheeos	REGISTER_A						
otom	REGISTER_B						
otor	REGISTER_A						
otor	REGISTER_B						
otoralch	REGISTER_B						
otorch	REGISTER_A						
otoreees	REGISTER_B						
otorshee	REGISTER_B						
otorsheod	REGISTER_A						
otos	REGISTER_A						
otos	REGISTER_B						
otota	REGISTER_A						
otoyd	REGISTER_B						
otsh	REGISTER_A						
otshd	REGISTER_B						
otshe	REGISTER_A						
otshe	REGISTER_B						
otshed	REGISTER_A						
otshed	REGISTER_B						
otsheo	REGISTER_B						
otshes	REGISTER_B						
otsho	REGISTER_A						
otshs	REGISTER_B						
otychd	REGISTER_A						
otyche	REGISTER_B						
otycheed	UNKNOWN						
otycoyl	REGISTER_B						
otyd	REGISTER_A						
otyd	REGISTER_B						
otyk	REGISTER_A						
otykee	REGISTER_A						
otyl	REGISTER_A						
otysh	REGISTER_A						
otyt	REGISTER_B						
otytch	REGISTER_A						
otyteeod	REGISTER_B						
ox	REGISTER_B						
oxar	REGISTER_B						
oydar	REGISTER_A						
oykeed	REGISTER_B						
oys	REGISTER_A						
oyteiedar	UNKNOWN						
oytoyd	REGISTER_A						
p	REGISTER_A						
p	REGISTER_B						
paich	REGISTER_B						
paiir	REGISTER_B						
par	REGISTER_B						
parad	REGISTER_B						
parar	REGISTER_B						
paroiin	REGISTER_B						
pch	REGISTER_A						
pch	REGISTER_B						
pchar	REGISTER_A						
pchar	REGISTER_B						
pchcfhd	REGISTER_A						
pchd	REGISTER_A						
pchd	REGISTER_B						
pchdair	REGISTER_B						
pchdar	REGISTER_B						
pchdeed	REGISTER_B						
pche	REGISTER_A						
pche	REGISTER_B						
pchear	REGISTER_A						
pched	REGISTER_A						
pched	REGISTER_B						
pchedar	REGISTER_B						
pchede	REGISTER_B						
pchee	REGISTER_A						
pchee	REGISTER_B						
pcheed	REGISTER_B						
pcheet	REGISTER_B						
pcheo	REGISTER_B						
pcheodar	REGISTER_B						
pcheol	REGISTER_A						
pcheos	REGISTER_B						
pchoct	REGISTER_A						
pchod	REGISTER_A						
pchod	REGISTER_B						
pchodar	REGISTER_B						
pchofar	REGISTER_B						
pchoiiin	REGISTER_A						
pchol	REGISTER_A						
pchol	REGISTER_B						
pcholk	REGISTER_B						
pchtchd	REGISTER_A						
pchykar	REGISTER_B						
pdan	REGISTER_A						
pesh	REGISTER_B						
poal	REGISTER_B						
pod	REGISTER_B						
podaiir	REGISTER_B						
podair	REGISTER_B						
podar	REGISTER_B						
podk	REGISTER_B						
pofoche	REGISTER_A						
poiis	REGISTER_A						
pokee	REGISTER_B						
pol	REGISTER_B						
polched	REGISTER_B						
pold	REGISTER_A						
pold	REGISTER_B						
polkeee	REGISTER_B						
polsh	REGISTER_B						
porar	REGISTER_A						
pot	REGISTER_A						
psched	REGISTER_B						
psh	REGISTER_A						
psh	REGISTER_B						
pshe	REGISTER_A						
pshed	REGISTER_B						
psheed	REGISTER_B						
psheoepo	REGISTER_A						
pshod	REGISTER_A						
pydal	REGISTER_B						
pydee	REGISTER_A						
pyke	REGISTER_B						
q	REGISTER_A						
q	REGISTER_B						
qakar	REGISTER_B						
qch	REGISTER_B						
qchar	REGISTER_B						
qchod	REGISTER_A						
qckh	REGISTER_B						
qckhe	REGISTER_A						
qckhear	REGISTER_B						
qckhed	REGISTER_B						
qckhh	REGISTER_B						
qcphh	REGISTER_B						
qcphhed	REGISTER_B						
qcth	REGISTER_B						
qcthdys	REGISTER_A						
qcthe	REGISTER_B						
qctheed	REGISTER_B						
qcthh	REGISTER_B						
qe	REGISTER_B						
qed	REGISTER_A						
qee	REGISTER_B						
qeed	REGISTER_A						
qeedar	REGISTER_B						
qeedee	REGISTER_A						
qeee	REGISTER_B						
qeeed	REGISTER_B						
qeeeear	REGISTER_B						
qeeo	REGISTER_B						
qef	REGISTER_B						
qek	REGISTER_A						
qek	REGISTER_B						
qekch	REGISTER_A						
qekchd	REGISTER_B						
qeke	REGISTER_B						
qeked	REGISTER_B						
qekeee	REGISTER_B						
qekeold	REGISTER_A						
qeokeh	REGISTER_A						
qeood	REGISTER_B						
qeos	REGISTER_A						
qepche	REGISTER_B						
qepched	REGISTER_B						
qepoep	REGISTER_B						
qet	REGISTER_A						
qet	REGISTER_B						
qetchar	REGISTER_B						
qetchd	REGISTER_B						
qetd	REGISTER_B						
qeykee	REGISTER_B						
qf	REGISTER_B						
qk	REGISTER_B						
qke	REGISTER_A						
qke	REGISTER_B						
qkee	REGISTER_A						
qkeee	REGISTER_A						
qko	REGISTER_B						
qkor	REGISTER_B						
qlk	REGISTER_B						
qo	REGISTER_A						
qo	REGISTER_B						
qoaiir	REGISTER_B						
qoaikh	REGISTER_A						
qoair	REGISTER_A						
qoair	REGISTER_B						
qoar	REGISTER_A						
qoar	REGISTER_B						
qoch	REGISTER_A						
qoch	REGISTER_B						
qochd	REGISTER_B						
qoche	REGISTER_A						
qoche	REGISTER_B						
qoched	REGISTER_B						
qocho	REGISTER_A						
qock	REGISTER_A						
qock	REGISTER_B						
qockh	REGISTER_A						
qockh	REGISTER_B						
qockhd	REGISTER_A						
qockhe	REGISTER_A						
qockhe	REGISTER_B						
qockhed	REGISTER_A						
qockhed	REGISTER_B						
qockhee	REGISTER_A						
qockhee	REGISTER_B						
qockheed	REGISTER_B						
qockhhd	REGISTER_A						
qockho	REGISTER_A						
qockhos	REGISTER_A						
qocph	REGISTER_A						
qocphd	REGISTER_B						
qocphe	REGISTER_A						
qocpheeckh	REGISTER_A						
qoct	REGISTER_B						
qocth	REGISTER_A						
qocth	REGISTER_B						
qocthd	REGISTER_B						
qocthe	REGISTER_A						
qocthe	REGISTER_B						
qocthed	REGISTER_B						
qocthes	REGISTER_B						
qoctho	REGISTER_B						
qod	REGISTER_A						
qod	REGISTER_B						
qodaiiin	REGISTER_B						
qodaiikh	REGISTER_A						
qodaim	REGISTER_A						
qodair	REGISTER_A						
qodair	REGISTER_B						
qodan	REGISTER_B						
qodar	REGISTER_A						
qodar	REGISTER_B						
qodch	REGISTER_A						
qodched	REGISTER_B						
qodckh	REGISTER_A						
qodcth	REGISTER_A						
qodee	REGISTER_B						
qodeed	REGISTER_B						
qodos	REGISTER_B						
qodyke	REGISTER_A						
qoe	REGISTER_A						
qoe	REGISTER_B						
qoeair	REGISTER_A						
qoear	REGISTER_A						
qoear	REGISTER_B						
qoed	REGISTER_B						
qoee	REGISTER_A						
qoee	REGISTER_B						
qoeear	REGISTER_B						
qoeech	REGISTER_B						
qoeechd	REGISTER_B						
qoeeckh	REGISTER_A						
qoeed	REGISTER_A						
qoeed	REGISTER_B						
qoeeda	REGISTER_B						
qoeede	REGISTER_B						
qoeee	REGISTER_A						
qoeee	REGISTER_B						
qoeeed	REGISTER_B						
qoeeee	REGISTER_B						
qoeeeet	REGISTER_A						
qoeees	REGISTER_B						
qoeekeed	REGISTER_B						
qoeeo	REGISTER_B						
qoeeok	REGISTER_A						
qoek	REGISTER_A						
qoek	REGISTER_B						
qoekal	REGISTER_B						
qoekchar	REGISTER_A						
qoeke	REGISTER_A						
qoeked	REGISTER_B						
qoekee	REGISTER_B						
qoekeeyke	REGISTER_B						
qoekshg	REGISTER_A						
qoepch	REGISTER_B						
qoesed	REGISTER_B						
qoet	REGISTER_A						
qoetar	REGISTER_B						
qoete	REGISTER_B						
qoetee	REGISTER_B						
qof	REGISTER_A						
qof	REGISTER_B						
qofair	REGISTER_A						
qofair	REGISTER_B						
qofch	REGISTER_A						
qofch	REGISTER_B						
qofchd	REGISTER_B						
qofchdar	REGISTER_B						
qofche	REGISTER_B						
qofched	REGISTER_A						
qofched	REGISTER_B						
qofockhd	REGISTER_B						
qofod	REGISTER_B						
qofoiin	REGISTER_A						
qoforom	REGISTER_A						
qofsh	REGISTER_B						
qofshd	REGISTER_B						
qofshe	REGISTER_A						
qofsheee	REGISTER_B						
qofyd	REGISTER_A						
qoihee	REGISTER_B						
qoiiin	REGISTER_A						
qoiiin	REGISTER_B						
qoiin	REGISTER_B						
qoikee	REGISTER_A						
qoin	REGISTER_A						
qoir	REGISTER_B						
qois	REGISTER_B						
qok	REGISTER_A						
qok	REGISTER_B						
qoka	REGISTER_A						
qokad	REGISTER_B						
qokaekeee	REGISTER_B						
qokai	REGISTER_B						
qokaiiin	REGISTER_B						
qokaiinos	REGISTER_B						
qokaiir	REGISTER_B						
qokaim	REGISTER_B						
qokair	REGISTER_A						
qokair	REGISTER_B						
qokairolchd	REGISTER_B						
qokal	REGISTER_B		family=F_BIO_CORE;role_group=BIO;primary_section=Biological;struct=CL_BIO	F_BIO_CORE	BIO	Biological	CL_BIO
qokalar	REGISTER_B						
qokalch	REGISTER_B						
qokalchar	REGISTER_B						
qokalchd	REGISTER_B						
qokalche	REGISTER_B						
qokald	REGISTER_A						
qokald	REGISTER_B						
qokaldar	REGISTER_A						
qokalom	REGISTER_A						
qokaloro	REGISTER_B						
qokalos	REGISTER_B						
qokalsh	REGISTER_B						
qokalshed	REGISTER_B						
qokamd	REGISTER_B						
qokan	REGISTER_B						
qokao	REGISTER_B						
qokar	REGISTER_A		family=F_BIO_CORE;role_group=BIO;primary_section=Biological;struct=CL_MIXED	F_BIO_CORE	BIO	Biological	CL_MIXED
qokar	REGISTER_B		family=F_BIO_CORE;role_group=BIO;primary_section=Biological;struct=CL_MIXED	F_BIO_CORE	BIO	Biological	CL_MIXED
qokarar	REGISTER_A						
qokas	REGISTER_B						
qokch	REGISTER_A						
qokch	REGISTER_B						
qokchar	REGISTER_B						
qokchd	REGISTER_A						
qokchd	REGISTER_B						
qokchd	UNKNOWN						
qokchdar	REGISTER_A						
qokchdyl	REGISTER_B						
qokche	REGISTER_A						
qokche	REGISTER_B						
qokched	REGISTER_A						
qokched	REGISTER_B						
qokchee	REGISTER_A						
qokchee	REGISTER_B						
qokcheed	REGISTER_B						
qokcheo	REGISTER_A						
qokchkee	REGISTER_B						
qokcho	REGISTER_A						
qokcho	REGISTER_B						
qokchocth	REGISTER_A						
qokchod	REGISTER_A						
qokchos	REGISTER_A						
qokchs	REGISTER_A						
qokchsh	REGISTER_A						
qokchyk	REGISTER_A						
qokd	REGISTER_A						
qokd	REGISTER_B						
qoke	REGISTER_A						
qoke	REGISTER_B						
qokeald	REGISTER_B						
qokear	REGISTER_B						
qokeas	REGISTER_B						
qokech	REGISTER_A						
qokech	REGISTER_B						
qokechckh	REGISTER_B						
qokechd	REGISTER_B						
qokeched	REGISTER_B						
qokecheos	REGISTER_B						
qoked	REGISTER_A						
qoked	REGISTER_B						
qoked	UNKNOWN						
qokedar	REGISTER_A						
qokedar	REGISTER_B						
qokeded	REGISTER_B						
qokedyd	REGISTER_A						
qokee	REGISTER_A						
qokee	REGISTER_B						
qokeear	REGISTER_B						
qokeeas	REGISTER_B						
qokeeashd	REGISTER_B						
qokeech	REGISTER_A						
qokeech	REGISTER_B						
qokeechom	REGISTER_A						
qokeed	REGISTER_A						
qokeed	REGISTER_B						
qokeed	UNKNOWN						
qokeedair	REGISTER_B						
qokeedar	REGISTER_A						
qokeedar	REGISTER_B						
qokeee	REGISTER_A						
qokeee	REGISTER_B						
qokeeed	REGISTER_B						
qokeeed	UNKNOWN						
qokeeen	REGISTER_A						
qokeeeos	REGISTER_B						
qokeees	REGISTER_A						
qokeees	REGISTER_B						
qokeefc	REGISTER_B						
qokeeiin	REGISTER_B						
qokeel	REGISTER_B						
qokeeo	REGISTER_A						
qokeeo	REGISTER_B						
qokeeod	REGISTER_B						
qokeeolche	REGISTER_B						
qokeeos	REGISTER_B						
qokees	REGISTER_B						
qokeesh	REGISTER_B						
qokeg	REGISTER_B						
qokehd	REGISTER_A						
qokeo	REGISTER_A						
qokeo	REGISTER_B						
qokeoch	REGISTER_B						
qokeod	REGISTER_A						
qokeod	REGISTER_B						
qokeoda	REGISTER_A						
qokeodair	REGISTER_B						
qokeog	REGISTER_A						
qokeoked	REGISTER_B						
qokeol	REGISTER_A						
qokeolo	REGISTER_A						
qokeom	REGISTER_A						
qokeor	REGISTER_B						
qokeos	REGISTER_A						
qokeos	REGISTER_B						
qoker	REGISTER_B						
qokes	REGISTER_B						
qokesd	REGISTER_B						
qokesh	REGISTER_B						
qokeshd	REGISTER_B						
qokeshe	REGISTER_B						
qokeshed	REGISTER_B						
qokeyl	REGISTER_A						
qokg	REGISTER_A						
qokiii	REGISTER_B						
qokiir	REGISTER_B						
qokl	REGISTER_B						
qoklchee	REGISTER_B						
qoko	REGISTER_A						
qoko	REGISTER_B						
qokoch	REGISTER_A						
qokod	REGISTER_A						
qokod	REGISTER_B						
qokoee	REGISTER_B						
qokoiiin	REGISTER_A						
qokoiin	REGISTER_A						
qokoiin	REGISTER_B						
qokoiir	REGISTER_A						
qokoin	REGISTER_B						
qokokch	REGISTER_A						
qokokil	REGISTER_B						
qokol	REGISTER_B						
qokolche	REGISTER_B						
qokolched	REGISTER_A						
qokold	REGISTER_B						
qokolk	REGISTER_B						
qokolkchd	REGISTER_B						
qokom	REGISTER_A						
qokomo	REGISTER_B						
qokop	REGISTER_B						
qokorar	REGISTER_A						
qokos	REGISTER_A						
qoksh	REGISTER_A						
qoksh	REGISTER_B						
qokshd	REGISTER_A						
qokshd	REGISTER_B						
qokshe	REGISTER_B						
qokshed	REGISTER_B						
qoksheo	REGISTER_B						
qokychd	REGISTER_B						
qokyd	REGISTER_A						
qokyl	REGISTER_B						
qokyldd	REGISTER_B						
qokyr	REGISTER_A						
qol	REGISTER_A		family=F_BIO_CORE;role_group=BIO;primary_section=Biological;struct=CL_BIO	F_BIO_CORE	BIO	Biological	CL_BIO
qol	REGISTER_B		family=F_BIO_CORE;role_group=BIO;primary_section=Biological;struct=CL_BIO	F_BIO_CORE	BIO	Biological	CL_BIO
qolair	REGISTER_B						
qolar	REGISTER_B						
qolchd	REGISTER_B						
qolche	REGISTER_A						
qolche	REGISTER_B						
qolched	REGISTER_A						
qolched	REGISTER_B						
qolchee	REGISTER_B						
qolcheed	REGISTER_B						
qold	REGISTER_A						
qoldar	REGISTER_B						
qolk	REGISTER_A						
qolk	REGISTER_B						
qolkch	REGISTER_A						
qolke	REGISTER_B						
qolked	REGISTER_B						
qolkee	REGISTER_A						
qolkee	REGISTER_B						
qolkeed	REGISTER_A						
qolkeed	REGISTER_B						
qolkeee	REGISTER_B						
qolkshe	REGISTER_B						
qolp	REGISTER_B						
qolr	REGISTER_B						
qols	REGISTER_A						
qolsh	REGISTER_B						
qolshe	REGISTER_A						
qolshe	REGISTER_B						
qolshed	REGISTER_A						
qolshee	REGISTER_A						
qolsheed	REGISTER_A						
qolsheed	REGISTER_B						
qolted	REGISTER_B						
qolteed	REGISTER_B						
qooch	REGISTER_B						
qooche	REGISTER_A						
qood	REGISTER_B						
qooiiin	REGISTER_A						
qooiin	REGISTER_B						
qoold	REGISTER_A						
qoolk	REGISTER_B						
qoolkee	REGISTER_B						
qoolkeed	REGISTER_B						
qoos	REGISTER_A						
qooto	REGISTER_A						
qop	REGISTER_A						
qop	REGISTER_B						
qopair	REGISTER_B						
qopal	REGISTER_B						
qopar	REGISTER_B						
qopch	REGISTER_A						
qopch	REGISTER_B						
qopchais	REGISTER_B						
qopchar	REGISTER_A						
qopchar	REGISTER_B						
qopchcfh	REGISTER_B						
qopchchs	REGISTER_B						
qopchd	REGISTER_A						
qopchd	REGISTER_B						
qopche	REGISTER_A						
qopche	REGISTER_B						
qopchear	REGISTER_B						
qopched	REGISTER_B						
qopchedd	REGISTER_B						
qopchedyd	REGISTER_B						
qopchee	REGISTER_B						
qopcheed	REGISTER_B						
qopcheo	REGISTER_B						
qopcheos	REGISTER_B						
qopches	REGISTER_B						
qopchet	REGISTER_B						
qopchol	REGISTER_A						
qopchsd	REGISTER_B						
qopchypcho	REGISTER_A						
qopchyr	REGISTER_B						
qopd	REGISTER_A						
qopd	REGISTER_B						
qopeed	REGISTER_B						
qopeeedar	REGISTER_B						
qopoee	REGISTER_B						
qopoiin	REGISTER_B						
qopshed	REGISTER_A						
qopshed	REGISTER_B						
qopyd	REGISTER_B						
qor	REGISTER_A						
qor	REGISTER_B						
qorar	REGISTER_B						
qorched	REGISTER_B						
qork	REGISTER_B						
qorsh	REGISTER_B						
qos	REGISTER_A						
qos	REGISTER_B						
qoschod	REGISTER_A						
qosee	REGISTER_B						
qosheckhh	REGISTER_A						
qoshed	REGISTER_B						
qot	REGISTER_A						
qot	REGISTER_B						
qotad	REGISTER_B						
qotaii	REGISTER_B						
qotaiiin	REGISTER_B						
qotail	REGISTER_B						
qotair	REGISTER_A						
qotair	REGISTER_B						
qotal	REGISTER_A		family=F_BIO_CORE;role_group=BIO;primary_section=Biological;struct=CL_MIXED	F_BIO_CORE	BIO	Biological	CL_MIXED
qotal	REGISTER_B		family=F_BIO_CORE;role_group=BIO;primary_section=Biological;struct=CL_MIXED	F_BIO_CORE	BIO	Biological	CL_MIXED
qotalched	REGISTER_B						
qotald	REGISTER_B						
qotalom	REGISTER_B						
qotals	REGISTER_B						
qotalsh	REGISTER_B						
qotan	REGISTER_A						
qotan	REGISTER_B						
qotar	REGISTER_A		family=F_PROC_CORE;role_group=PROC;primary_section=Recipes;struct=CL_MIXED	F_PROC_CORE	PROC	Recipes	CL_MIXED
qotar	REGISTER_B		family=F_PROC_CORE;role_group=PROC;primary_section=Recipes;struct=CL_MIXED	F_PROC_CORE	PROC	Recipes	CL_MIXED
qotas	REGISTER_A						
qotas	REGISTER_B						
qotch	REGISTER_A						
qotch	REGISTER_B						
qotchar	REGISTER_A						
qotchd	REGISTER_A						
qotchd	REGISTER_B						
qotchdar	REGISTER_B						
qotche	REGISTER_A						
qotche	REGISTER_B						
qotched	REGISTER_A						
qotched	REGISTER_B						
qotchedar	REGISTER_B						
qotcheed	REGISTER_B						
qotcheo	REGISTER_A						
qotcheo	REGISTER_B						
qotches	REGISTER_B						
qotcho	REGISTER_A						
qotcho	REGISTER_B						
qotchod	REGISTER_A						
qotcholm	REGISTER_A						
qotchor	REGISTER_B						
qotchotch	REGISTER_A						
qotchs	REGISTER_B						
qotdct	REGISTER_B						
qotddyar	REGISTER_B						
qote	REGISTER_A						
qote	REGISTER_B						
qotea	REGISTER_A						
qotear	REGISTER_B						
qotech	REGISTER_B						
qoted	REGISTER_A						
qoted	REGISTER_B						
qotedais	REGISTER_B						
qotedar	REGISTER_B						
qotedl	REGISTER_B						
qotee	REGISTER_A						
qotee	REGISTER_B						
qoteed	REGISTER_A						
qoteed	REGISTER_B						
qoteedar	REGISTER_B						
qoteedar	UNKNOWN						
qoteedd	REGISTER_B						
qoteedo	REGISTER_B						
qoteee	REGISTER_A						
qoteee	REGISTER_B						
qoteeed	REGISTER_B						
qoteeo	REGISTER_A						
qoteeo	REGISTER_B						
qoteeod	REGISTER_B						
qoteeos	REGISTER_B						
qoteeotch	REGISTER_B						
qotees	REGISTER_A						
qotees	REGISTER_B						
qoteo	REGISTER_A						
qoteo	REGISTER_B						
qoteod	REGISTER_B						
qoteode	REGISTER_B						
qoteol	REGISTER_B						
qoteold	REGISTER_A						
qoteos	REGISTER_B						
qotes	REGISTER_B						
qotesh	REGISTER_B						
qoteytyqok	REGISTER_B						
qotir	REGISTER_B						
qotl	REGISTER_B						
qotlolk	REGISTER_B						
qoto	REGISTER_A						
qoto	REGISTER_B						
qotocthe	REGISTER_B						
qotod	REGISTER_A						
qotoee	REGISTER_A						
qotoeetch	REGISTER_B						
qotoh	REGISTER_B						
qotoiin	REGISTER_A						
qotoiir	REGISTER_A						
qotok	REGISTER_B						
qotol	REGISTER_B						
qotolch	REGISTER_B						
qotolchd	REGISTER_B						
qotolcheo	REGISTER_B						
qotold	REGISTER_A						
qotolo	REGISTER_A						
qotom	REGISTER_B						
qotos	REGISTER_B						
qototeee	REGISTER_B						
qotsh	REGISTER_A						
qotsh	REGISTER_B						
qotshd	REGISTER_B						
qotshe	REGISTER_A						
qotshe	REGISTER_B						
qotshed	REGISTER_B						
qotsheod	REGISTER_A						
qotsheod	REGISTER_B						
qotyd	REGISTER_A						
qotyl	REGISTER_B						
qotyshe	REGISTER_B						
qoyk	REGISTER_B						
qoykee	REGISTER_B						
qoykeee	REGISTER_A						
qp	REGISTER_A						
qpched	REGISTER_B						
qs	REGISTER_B						
qsolkeed	REGISTER_A						
qt	REGISTER_B						
qyk	REGISTER_B						
qykche	REGISTER_A						
qyoee	REGISTER_A						
r	REGISTER_A		family=F_BOTANICAL_CORE;role_group=BOT;primary_section=Herbal;struct=CL_MIXED	F_BOTANICAL_CORE	BOT	Herbal	CL_MIXED
r	REGISTER_B		family=F_BOTANICAL_CORE;role_group=BOT;primary_section=Herbal;struct=CL_MIXED	F_BOTANICAL_CORE	BOT	Herbal	CL_MIXED
r	UNKNOWN		family=F_BOTANICAL_CORE;role_group=BOT;primary_section=Herbal;struct=CL_MIXED	F_BOTANICAL_CORE	BOT	Herbal	CL_MIXED
raif	REGISTER_B						
raiiin	REGISTER_B						
raiis	REGISTER_B						
raikch	REGISTER_B						
rain	REGISTER_A						
rair	REGISTER_B						
rais	REGISTER_B						
rait	REGISTER_B						
raitht	REGISTER_B						
ral	REGISTER_B						
ralch	REGISTER_B						
ralchl	REGISTER_B						
ralchs	REGISTER_B						
rald	REGISTER_A						
raldl	REGISTER_B						
ralk	REGISTER_B						
ralkched	REGISTER_B						
ralom	REGISTER_B						
ramsh	REGISTER_B						
rar	REGISTER_A						
rar	REGISTER_B						
rarolchl	REGISTER_B						
ras	REGISTER_B						
rch	REGISTER_A						
rch	REGISTER_B						
rchar	REGISTER_B						
rchch	REGISTER_B						
rche	REGISTER_A						
rche	REGISTER_B						
rchealch	REGISTER_A						
rched	REGISTER_A						
rched	REGISTER_B						
rchee	REGISTER_A						
rchee	REGISTER_B						
rcheeo	REGISTER_B						
rchees	REGISTER_B						
rcheete	REGISTER_B						
rchek	REGISTER_A						
rchek	REGISTER_B						
rcheo	REGISTER_B						
rcheod	REGISTER_A						
rcheold	REGISTER_B						
rches	REGISTER_B						
rchl	REGISTER_B						
rchos	REGISTER_B						
rchr	REGISTER_A						
rchs	REGISTER_A						
rchs	REGISTER_B						
reee	REGISTER_B						
rf	REGISTER_B						
rk	REGISTER_B						
rkar	REGISTER_B						
rkchd	REGISTER_A						
rked	REGISTER_A						
rkee	REGISTER_B						
rkeeo	REGISTER_A						
rl	REGISTER_B						
rn	REGISTER_A						
ro	REGISTER_A						
ro	REGISTER_B						
rod	REGISTER_B						
rodeed	REGISTER_B						
roiin	REGISTER_B						
roiir	REGISTER_B						
roir	REGISTER_A						
rokeed	REGISTER_B						
rol	REGISTER_B						
rolch	REGISTER_B						
rolche	REGISTER_B						
rolched	REGISTER_A						
rolk	REGISTER_B						
rolkee	REGISTER_B						
rolot	REGISTER_A						
rolshe	REGISTER_B						
rolsheed	REGISTER_B						
rom	REGISTER_A						
rom	REGISTER_B						
ror	REGISTER_B						
rorchee	REGISTER_B						
ros	REGISTER_B						
rot	REGISTER_B						
rotyd	REGISTER_B						
rpche	REGISTER_B						
rshd	REGISTER_A						
rshe	REGISTER_A						
rshe	REGISTER_B						
rshed	REGISTER_A						
rshed	REGISTER_B						
rsheed	REGISTER_A						
rsheed	REGISTER_B						
rsheedar	REGISTER_B						
rte	REGISTER_B						
s	REGISTER_A		family=F_BOTANICAL_CORE;role_group=BOT;primary_section=Herbal;struct=CL_BOTANICAL	F_BOTANICAL_CORE	BOT	Herbal	CL_BOTANICAL
s	REGISTER_B		family=F_BOTANICAL_CORE;role_group=BOT;primary_section=Herbal;struct=CL_BOTANICAL	F_BOTANICAL_CORE	BOT	Herbal	CL_BOTANICAL
s	UNKNOWN		family=F_BOTANICAL_CORE;role_group=BOT;primary_section=Herbal;struct=CL_BOTANICAL	F_BOTANICAL_CORE	BOT	Herbal	CL_BOTANICAL
sa	REGISTER_A						
sai	REGISTER_A						
saiid	REGISTER_A						
saiim	REGISTER_B						
saiind	REGISTER_A						
saiir	REGISTER_A						
saiir	REGISTER_B						
sail	REGISTER_B						
saim	REGISTER_B						
saimch	REGISTER_A						
sainn	REGISTER_A						
saino	REGISTER_A						
sair	REGISTER_A						
sair	REGISTER_B						
sairn	REGISTER_B						
sairom	REGISTER_B						
sais	REGISTER_B						
sakar	REGISTER_A						
sal	REGISTER_A						
sal	REGISTER_B						
salched	REGISTER_A						
salched	REGISTER_B						
sald	REGISTER_A						
sald	REGISTER_B						
salkeed	REGISTER_B						
salo	REGISTER_B						
sals	REGISTER_A						
salshcthd	REGISTER_A						
salsoiin	REGISTER_B						
saltar	REGISTER_B						
salted	REGISTER_B						
san	REGISTER_B						
sand	REGISTER_B						
sar	REGISTER_A						
sar	REGISTER_B						
saraisl	REGISTER_B						
sas	UNKNOWN						
satar	REGISTER_A						
sayfched	REGISTER_A						
sc	REGISTER_B						
sch	REGISTER_A						
schar	REGISTER_A						
schckh	REGISTER_A						
schcth	REGISTER_B						
schd	REGISTER_A						
schd	REGISTER_B						
sche	REGISTER_A						
sche	REGISTER_B						
sched	REGISTER_A						
schee	REGISTER_A						
schee	REGISTER_B						
scheer	REGISTER_B						
schek	REGISTER_A						
scheom	REGISTER_A						
sches	REGISTER_B						
scho	REGISTER_A						
schoshe	REGISTER_A						
schsd	REGISTER_B						
sckhe	REGISTER_A						
scth	REGISTER_A						
se	REGISTER_B						
sed	REGISTER_B						
see	REGISTER_A						
seear	REGISTER_B						
seed	REGISTER_B						
seeder	REGISTER_A						
seee	REGISTER_A						
seees	REGISTER_A						
seesal	REGISTER_B						
seoar	REGISTER_B						
sf	REGISTER_A						
sh	REGISTER_A						
sh	REGISTER_B						
sh	UNKNOWN						
sha	REGISTER_A						
shaikh	REGISTER_A						
shaikh	REGISTER_B						
shaikhh	REGISTER_B						
shair	REGISTER_A						
shal	REGISTER_B						
shald	REGISTER_B						
shalk	REGISTER_B						
shalkl	REGISTER_B						
shalom	REGISTER_B						
shan	REGISTER_A						
shar	REGISTER_A						
shar	REGISTER_B						
shcfh	REGISTER_A						
shch	REGISTER_A						
shch	REGISTER_B						
shchd	REGISTER_B						
shche	REGISTER_A						
shche	REGISTER_B						
shckh	REGISTER_A						
shckh	REGISTER_B						
shckhch	REGISTER_A						
shckhdch	REGISTER_A						
shckhe	REGISTER_A						
shckhe	REGISTER_B						
shckhed	REGISTER_A						
shckhed	REGISTER_B						
shckhef	REGISTER_B						
shckhh	REGISTER_B						
shckhhd	REGISTER_A						
shcph	REGISTER_A						
shcphh	REGISTER_B						
shcpho	REGISTER_B						
shct	REGISTER_B						
shcth	REGISTER_A						
shcth	REGISTER_B						
shcth	UNKNOWN						
shcthd	REGISTER_B						
shcthe	REGISTER_A						
shcthe	REGISTER_B						
shcthed	REGISTER_B						
shcthh	REGISTER_A						
shcthh	REGISTER_B						
shd	REGISTER_A						
shd	REGISTER_B						
shda	REGISTER_B						
shdair	REGISTER_B						
shdald	REGISTER_B						
shdalk	REGISTER_B						
shdalo	REGISTER_A						
shdar	REGISTER_B						
shdchd	REGISTER_A						
shdd	REGISTER_B						
shdpch	REGISTER_B						
shdyd	REGISTER_B						
shdykair	REGISTER_B						
shdyt	REGISTER_B						
she	REGISTER_A						
she	REGISTER_B						
she	UNKNOWN						
shea	REGISTER_A						
sheal	REGISTER_A						
shear	REGISTER_A						
shear	REGISTER_B						
sheas	REGISTER_B						
shech	REGISTER_B						
sheckee	REGISTER_B						
sheckh	REGISTER_A						
sheckh	REGISTER_B						
sheckhd	REGISTER_B						
sheckhe	REGISTER_B						
sheckhed	REGISTER_A						
sheckhed	REGISTER_B						
shecph	REGISTER_A						
shecph	REGISTER_B						
shecphhd	REGISTER_B						
shecth	REGISTER_A						
shecth	REGISTER_B						
shecthe	REGISTER_B						
shecthed	REGISTER_B						
shectyh	REGISTER_B						
shed	REGISTER_A						
shed	REGISTER_B						
shed	UNKNOWN						
shedaiiin	REGISTER_B						
shedait	REGISTER_B						
shedar	REGISTER_A						
shedar	REGISTER_B						
shedeee	REGISTER_B						
shedked	REGISTER_B						
sheds	REGISTER_B						
shedshe	REGISTER_B						
shedykeyl	UNKNOWN						
shee	REGISTER_A						
shee	REGISTER_B						
shee	UNKNOWN						
sheea	REGISTER_B						
sheear	REGISTER_A						
sheear	REGISTER_B						
sheeckh	REGISTER_B						
sheecthe	REGISTER_B						
sheed	REGISTER_A						
sheed	REGISTER_B						
sheedar	REGISTER_B						
sheedo	REGISTER_A						
sheedo	REGISTER_B						
sheedom	REGISTER_A						
sheee	REGISTER_A						
sheee	REGISTER_B						
sheeek	REGISTER_A						
sheeek	REGISTER_B						
sheeen	REGISTER_B						
sheeerl	REGISTER_B						
sheees	REGISTER_A						
sheees	REGISTER_B						
sheeetch	REGISTER_B						
sheef	REGISTER_B						
sheek	REGISTER_A						
sheek	REGISTER_B						
sheekar	REGISTER_B						
sheekas	REGISTER_B						
sheekch	REGISTER_B						
sheeke	REGISTER_A						
sheekee	REGISTER_B						
sheekl	REGISTER_B						
sheel	REGISTER_A						
sheeo	REGISTER_B						
sheeod	REGISTER_A						
sheeod	REGISTER_B						
sheeodar	REGISTER_B						
sheeodees	REGISTER_B						
sheeoek	REGISTER_B						
sheeol	REGISTER_A						
sheeol	REGISTER_B						
sheeos	REGISTER_A						
sheep	REGISTER_B						
shees	REGISTER_A						
shees	REGISTER_B						
sheet	REGISTER_A						
sheet	REGISTER_B						
sheetch	REGISTER_A						
sheete	REGISTER_A						
sheete	REGISTER_B						
shefchd	REGISTER_A						
shefchd	REGISTER_B						
shefhed	REGISTER_B						
shefshoro	REGISTER_B						
shek	REGISTER_A						
shek	REGISTER_B						
shekaiiin	REGISTER_B						
shekair	REGISTER_B						
shekalchd	REGISTER_A						
shekar	REGISTER_A						
shekar	REGISTER_B						
shekch	REGISTER_A						
shekch	REGISTER_B						
sheke	REGISTER_A						
sheke	REGISTER_B						
sheked	REGISTER_A						
sheked	REGISTER_B						
shekee	REGISTER_A						
shekee	REGISTER_B						
shekeef	REGISTER_B						
shekeod	REGISTER_A						
shekshe	REGISTER_A						
shekshe	REGISTER_B						
sheksheet	REGISTER_A						
shel	REGISTER_B						
sheo	REGISTER_A						
sheo	REGISTER_B						
sheo	UNKNOWN						
sheockh	REGISTER_A						
sheockhe	REGISTER_A						
sheockhe	REGISTER_B						
sheockhed	REGISTER_B						
sheocph	REGISTER_B						
sheocth	REGISTER_B						
sheod	REGISTER_A						
sheod	REGISTER_B						
sheodal	REGISTER_B						
sheoeed	REGISTER_B						
sheoees	REGISTER_A						
sheoek	REGISTER_B						
sheoikh	REGISTER_B						
sheok	REGISTER_A						
sheok	REGISTER_B						
sheoka	UNKNOWN						
sheokar	REGISTER_B						
sheoke	REGISTER_A						
sheoke	REGISTER_B						
sheoked	REGISTER_B						
sheokee	REGISTER_A						
sheokeed	REGISTER_B						
sheol	REGISTER_B		family=F_PROC_CORE;role_group=PROC;primary_section=Biological;struct=CL_PROC_LEFT	F_PROC_CORE	PROC	Biological	CL_PROC_LEFT
sheold	REGISTER_A						
sheold	REGISTER_B						
sheolk	REGISTER_B						
sheolkch	REGISTER_B						
sheolke	REGISTER_B						
sheolked	REGISTER_A						
sheolkee	REGISTER_B						
sheolkeed	REGISTER_B						
sheolo	REGISTER_A						
sheols	REGISTER_A						
sheols	REGISTER_B						
sheolsh	REGISTER_B						
sheolte	REGISTER_B						
sheom	REGISTER_A						
sheom	REGISTER_B						
sheopch	REGISTER_B						
sheos	REGISTER_A						
sheos	REGISTER_B						
sheos	UNKNOWN						
sheot	REGISTER_A						
sheot	REGISTER_B						
sheoteol	REGISTER_A						
shep	REGISTER_A						
shep	REGISTER_B						
shepch	REGISTER_A						
shepch	REGISTER_B						
shepchd	REGISTER_B						
shepched	REGISTER_B						
shepd	REGISTER_A						
sheqok	REGISTER_A						
sher	REGISTER_A						
sher	REGISTER_B						
shes	REGISTER_A						
shes	REGISTER_B						
shesed	REGISTER_A						
shesee	REGISTER_B						
shesek	REGISTER_B						
sheshd	REGISTER_B						
shet	REGISTER_A						
shet	REGISTER_B						
shetar	REGISTER_B						
shetch	REGISTER_A						
shetch	REGISTER_B						
shete	REGISTER_A						
shete	REGISTER_B						
shets	REGISTER_B						
shetsho	REGISTER_B						
sheycth	REGISTER_B						
sheyk	REGISTER_B						
sheykaiiin	REGISTER_B						
sheyr	REGISTER_A						
sheyr	REGISTER_B						
sheys	REGISTER_B						
sheytchd	REGISTER_B						
shf	REGISTER_B						
shfyd	REGISTER_A						
shh	REGISTER_B						
shk	REGISTER_A						
shk	REGISTER_B						
shka	REGISTER_B						
shkair	REGISTER_A						
shkair	REGISTER_B						
shkakeed	REGISTER_B						
shkar	REGISTER_B						
shkch	REGISTER_A						
shkch	REGISTER_B						
shkche	REGISTER_B						
shkched	REGISTER_B						
shke	REGISTER_A						
shke	REGISTER_B						
shkech	REGISTER_B						
shkee	REGISTER_A						
shkee	REGISTER_B						
shkeeo	REGISTER_A						
shkh	REGISTER_B						
shko	REGISTER_A						
shl	REGISTER_B						
shlches	REGISTER_B						
shld	REGISTER_A						
shld	REGISTER_B						
sho	REGISTER_A		family=F_BOTANICAL_CORE;role_group=BOT;primary_section=Herbal;struct=CL_BOTANICAL	F_BOTANICAL_CORE	BOT	Herbal	CL_BOTANICAL
sho	REGISTER_B		family=F_BOTANICAL_CORE;role_group=BOT;primary_section=Herbal;struct=CL_BOTANICAL	F_BOTANICAL_CORE	BOT	Herbal	CL_BOTANICAL
sho	UNKNOWN		family=F_BOTANICAL_CORE;role_group=BOT;primary_section=Herbal;struct=CL_BOTANICAL	F_BOTANICAL_CORE	BOT	Herbal	CL_BOTANICAL
shoald	REGISTER_A						
shoar	REGISTER_B						
shocfh	REGISTER_B						
shocfhe	REGISTER_B						
shoch	REGISTER_A						
shockh	REGISTER_A						
shockh	REGISTER_B						
shockhch	REGISTER_A						
shockhe	REGISTER_A						
shockho	REGISTER_A						
shockhs	REGISTER_B						
shocph	REGISTER_A						
shocphed	REGISTER_B						
shocphh	REGISTER_A						
shocth	REGISTER_A						
shocth	REGISTER_B						
shocthe	REGISTER_A						
shocthh	REGISTER_A						
shod	REGISTER_A						
shod	REGISTER_B						
shoda	REGISTER_B						
shodan	REGISTER_A						
shodar	REGISTER_A						
shoef	REGISTER_B						
shoefchee	REGISTER_B						
shoek	REGISTER_B						
shoekar	REGISTER_B						
shoeke	REGISTER_B						
shoet	REGISTER_A						
shof	REGISTER_B						
shofshed	REGISTER_B						
shoifh	REGISTER_B						
shoiin	REGISTER_A						
shoikh	REGISTER_A						
shoikh	REGISTER_B						
shok	REGISTER_A						
shok	REGISTER_B						
shokaiir	REGISTER_B						
shokal	REGISTER_B						
shokar	REGISTER_B						
shokch	REGISTER_A						
shokch	REGISTER_B						
shokchee	REGISTER_A						
shoke	REGISTER_A						
shoke	REGISTER_B						
shokee	REGISTER_A						
shokee	REGISTER_B						
shokeedar	REGISTER_B						
shokees	REGISTER_B						
shokeolls	REGISTER_A						
shoko	REGISTER_B						
shokocfh	REGISTER_A						
shokog	REGISTER_A						
shoksh	REGISTER_A						
shol	REGISTER_A		family=F_BOTANICAL_CORE;role_group=BOT;primary_section=Herbal;struct=CL_BOTANICAL	F_BOTANICAL_CORE	BOT	Herbal	CL_BOTANICAL
shol	REGISTER_B		family=F_BOTANICAL_CORE;role_group=BOT;primary_section=Herbal;struct=CL_BOTANICAL	F_BOTANICAL_CORE	BOT	Herbal	CL_BOTANICAL
sholal	REGISTER_B						
sholar	REGISTER_B						
shold	REGISTER_A						
shold	REGISTER_B						
sholf	REGISTER_B						
sholfch	REGISTER_A						
sholfosd	REGISTER_B						
sholkair	REGISTER_B						
sholkar	REGISTER_B						
sholkeech	REGISTER_B						
sholkeed	REGISTER_B						
sholksh	REGISTER_A						
sholo	REGISTER_A						
sholoiin	REGISTER_A						
sholsche	REGISTER_A						
sholte	REGISTER_B						
shom	REGISTER_A						
shom	REGISTER_B						
shoo	REGISTER_B						
shopch	REGISTER_A						
shopch	REGISTER_B						
shopcho	REGISTER_A						
shopcho	REGISTER_B						
shopolched	REGISTER_B						
shoqok	REGISTER_A						
shor	REGISTER_A		family=F_BOTANICAL_CORE;role_group=BOT;primary_section=Herbal;struct=CL_BOTANICAL	F_BOTANICAL_CORE	BOT	Herbal	CL_BOTANICAL
shor	REGISTER_B		family=F_BOTANICAL_CORE;role_group=BOT;primary_section=Herbal;struct=CL_BOTANICAL	F_BOTANICAL_CORE	BOT	Herbal	CL_BOTANICAL
shorchd	REGISTER_B						
shorche	REGISTER_A						
shorkch	REGISTER_A						
shorpch	REGISTER_A						
shorydar	REGISTER_A						
shos	REGISTER_A						
shos	REGISTER_B						
shos	UNKNOWN						
shosh	REGISTER_A						
shot	REGISTER_A						
shot	REGISTER_B						
shotch	REGISTER_B						
shotchd	REGISTER_B						
shotche	REGISTER_B						
shote	REGISTER_B						
shoted	REGISTER_B						
shotee	REGISTER_B						
shotol	REGISTER_A						
shotsh	REGISTER_A						
shoyfar	REGISTER_B						
shoyt	REGISTER_A						
shr	REGISTER_A						
shr	REGISTER_B						
shs	REGISTER_B						
shsd	REGISTER_A						
shsd	REGISTER_B						
shse	REGISTER_B						
shses	REGISTER_B						
shsh	REGISTER_A						
shshdar	REGISTER_B						
shshes	REGISTER_A						
shsk	REGISTER_B						
shso	REGISTER_B						
shsop	REGISTER_A						
sht	REGISTER_A						
sht	REGISTER_B						
shtar	REGISTER_B						
shtch	REGISTER_A						
shtch	REGISTER_B						
shte	REGISTER_A						
shte	REGISTER_B						
shtsh	REGISTER_A						
shtsh	REGISTER_B						
shx	REGISTER_B						
shy	REGISTER_B		family=F_BOTANICAL_CORE;role_group=BOT;primary_section=Herbal;struct=CL_BOTANICAL	F_BOTANICAL_CORE	BOT	Herbal	CL_BOTANICAL
shyokee	REGISTER_A						
shypched	REGISTER_B						
shysh	REGISTER_A						
shysho	REGISTER_A						
shytch	REGISTER_A						
siiin	REGISTER_B						
sk	REGISTER_B						
skaiiodar	REGISTER_A						
skchd	REGISTER_B						
skee	REGISTER_A						
skekyd	REGISTER_A						
sls	REGISTER_B						
so	REGISTER_A						
socfchees	REGISTER_A						
sockhe	REGISTER_A						
socthh	REGISTER_A						
sod	REGISTER_A						
sodaiiin	REGISTER_B						
sodair	REGISTER_B						
sodar	REGISTER_A						
sodar	REGISTER_B						
soear	UNKNOWN						
soeeed	REGISTER_B						
soeees	REGISTER_A						
soefchocph	REGISTER_A						
soeokeot	REGISTER_A						
soeos	REGISTER_A						
soeteed	REGISTER_A						
soiiin	REGISTER_A						
soiiin	REGISTER_B						
soiin	REGISTER_A						
soiir	REGISTER_B						
soin	REGISTER_A						
sok	REGISTER_B						
soked	REGISTER_B						
sokee	REGISTER_A						
sokee	REGISTER_B						
sol	REGISTER_A						
solche	REGISTER_B						
solched	REGISTER_B						
solcth	REGISTER_B						
sold	REGISTER_B						
solk	REGISTER_B						
solked	REGISTER_A						
sols	REGISTER_A						
solshe	REGISTER_B						
solshed	REGISTER_B						
som	REGISTER_B						
sor	REGISTER_A						
sor	REGISTER_B						
soraiis	REGISTER_B						
soraloal	REGISTER_B						
sorar	REGISTER_A						
sos	REGISTER_A						
sos	REGISTER_B						
sosh	REGISTER_A						
sot	REGISTER_A						
sot	REGISTER_B						
sote	REGISTER_A						
sote	REGISTER_B						
soteees	REGISTER_B						
sp	REGISTER_B						
spch	REGISTER_A						
ssear	REGISTER_B						
sses	REGISTER_A						
ssh	REGISTER_B						
ssheo	REGISTER_A						
stolpch	REGISTER_B						
syd	REGISTER_A						
syd	REGISTER_B						
syk	REGISTER_A						
sykeeeoch	REGISTER_B						
syshees	REGISTER_B						
syt	REGISTER_A						
t	REGISTER_A						
t	REGISTER_B						
taid	REGISTER_B						
taiiin	REGISTER_A						
taik	REGISTER_B						
taikh	REGISTER_B						
taim	REGISTER_B						
taipar	REGISTER_B						
tair	REGISTER_B						
tairo	REGISTER_B						
tal	REGISTER_B						
talar	REGISTER_B						
talchos	REGISTER_B						
tald	REGISTER_B						
taldar	REGISTER_B						
talshd	REGISTER_B						
tan	REGISTER_A						
tar	REGISTER_A						
tar	REGISTER_B						
tarair	REGISTER_B						
taros	REGISTER_B						
tas	REGISTER_B						
tcfh	REGISTER_B						
tch	REGISTER_A						
tch	REGISTER_B						
tchal	REGISTER_A						
tchar	REGISTER_A						
tchar	REGISTER_B						
tchcth	REGISTER_B						
tchd	REGISTER_A						
tchd	REGISTER_B						
tchdar	REGISTER_B						
tchdoltd	REGISTER_B						
tche	REGISTER_A						
tche	REGISTER_B						
tchea	REGISTER_A						
tched	REGISTER_A						
tched	REGISTER_B						
tchedar	REGISTER_B						
tchedyd	REGISTER_B						
tchee	REGISTER_A						
tchee	REGISTER_B						
tcheen	REGISTER_A						
tcheepche	REGISTER_B						
tcheo	REGISTER_B						
tcheod	REGISTER_A						
tcheodar	REGISTER_B						
tcho	REGISTER_A						
tchod	REGISTER_A						
tchodar	REGISTER_A						
tchokyd	REGISTER_A						
tchol	REGISTER_A						
tchol	REGISTER_B						
tchols	REGISTER_A						
tchols	REGISTER_B						
tchor	REGISTER_A						
tchos	REGISTER_A						
tchykch	REGISTER_A						
td	REGISTER_A						
td	REGISTER_B						
te	REGISTER_A						
te	REGISTER_B						
te	UNKNOWN						
tear	REGISTER_B						
ted	REGISTER_A						
ted	REGISTER_B						
tedair	REGISTER_B						
tedar	REGISTER_A						
tedas	REGISTER_A						
tedo	REGISTER_B						
tedy	REGISTER_B						
tee	REGISTER_A						
tee	REGISTER_B						
tee	UNKNOWN						
teear	REGISTER_B						
teed	REGISTER_A						
teed	REGISTER_B						
teedan	REGISTER_B						
teedar	REGISTER_B						
teee	REGISTER_B						
teeed	REGISTER_B						
teeoar	REGISTER_B						
teeod	REGISTER_B						
teeolteed	REGISTER_B						
teeos	REGISTER_A						
teeys	REGISTER_A						
teo	REGISTER_A						
teod	REGISTER_A						
teod	REGISTER_B						
teoda	UNKNOWN						
teodar	REGISTER_A						
teodk	REGISTER_B						
teodyteytar	REGISTER_B						
teolkeche	REGISTER_A						
teolked	REGISTER_B						
teols	REGISTER_A						
teolsh	REGISTER_B						
teos	REGISTER_B						
teotee	REGISTER_B						
tes	REGISTER_B						
teyteg	REGISTER_B						
the	REGISTER_A						
tl	REGISTER_B						
to	REGISTER_A						
to	REGISTER_B						
toar	REGISTER_B						
toch	REGISTER_A						
tochs	REGISTER_B						
tockh	REGISTER_A						
tod	REGISTER_A						
tod	REGISTER_B						
todashx	REGISTER_B						
tok	REGISTER_B						
tokar	REGISTER_B						
tol	REGISTER_A						
tol	REGISTER_B						
tolair	REGISTER_B						
tolched	REGISTER_B						
tolchor	REGISTER_A						
told	REGISTER_A						
tolk	REGISTER_B						
tolm	REGISTER_A						
tolokeed	REGISTER_A						
tolpch	REGISTER_B						
tom	REGISTER_A						
top	REGISTER_B						
tor	REGISTER_A						
tor	REGISTER_B						
torch	REGISTER_A						
tos	REGISTER_A						
tot	REGISTER_B						
tsh	REGISTER_A						
tsh	REGISTER_B						
tshal	REGISTER_B						
tshd	REGISTER_B						
tshe	REGISTER_A						
tshe	REGISTER_B						
tshed	REGISTER_B						
tshee	REGISTER_B						
tsheokeed	REGISTER_B						
tshes	REGISTER_B						
tsho	REGISTER_A						
tsho	REGISTER_B						
tshod	REGISTER_A						
tshodees	REGISTER_A						
tyd	REGISTER_A						
v	REGISTER_A						
vo	REGISTER_A						
vs	REGISTER_A						
x	REGISTER_A						
xaloeees	REGISTER_A						
xar	REGISTER_A						
xar	REGISTER_B						
xoiin	REGISTER_B						
xsl	REGISTER_A						
y	REGISTER_A		family=F_BOTANICAL_CORE;role_group=BOT;primary_section=Herbal;struct=CL_BOTANICAL	F_BOTANICAL_CORE	BOT	Herbal	CL_BOTANICAL
y	REGISTER_B		family=F_BOTANICAL_CORE;role_group=BOT;primary_section=Herbal;struct=CL_BOTANICAL	F_BOTANICAL_CORE	BOT	Herbal	CL_BOTANICAL
y	UNKNOWN		family=F_BOTANICAL_CORE;role_group=BOT;primary_section=Herbal;struct=CL_BOTANICAL	F_BOTANICAL_CORE	BOT	Herbal	CL_BOTANICAL
ych	REGISTER_A						
ychar	REGISTER_B						
yche	REGISTER_A						
yche	REGISTER_B						
ychear	REGISTER_A						
ychear	REGISTER_B						
yched	REGISTER_B						
ychedar	REGISTER_B						
ychee	REGISTER_B						
ycheed	REGISTER_A						
ycheed	REGISTER_B						
ycheeo	REGISTER_B						
ycheet	REGISTER_A						
ychek	REGISTER_B						
ycheo	REGISTER_A						
ycheok	REGISTER_B						
ycheom	REGISTER_A						
yches	REGISTER_B						
ycho	REGISTER_A						
ycho	REGISTER_B						
ychoees	REGISTER_A						
ychoop	REGISTER_A						
ychopordg	REGISTER_A						
ychs	REGISTER_A						
ycht	REGISTER_B						
yckh	REGISTER_B						
yckhe	REGISTER_A						
ycphko	REGISTER_A						
yd	REGISTER_A						
yd	REGISTER_B						
ydar	REGISTER_A						
ydarchom	REGISTER_A						
ydl	REGISTER_A						
ydol	REGISTER_B						
ydys	REGISTER_B						
ye	REGISTER_B						
yeed	REGISTER_A						
yef	REGISTER_B						
yeke	REGISTER_A						
yf	REGISTER_A						
yf	REGISTER_B						
yfch	REGISTER_A						
yfchd	REGISTER_A						
yfche	REGISTER_B						
yfched	REGISTER_A						
yfchek	REGISTER_A						
yfod	REGISTER_A						
yfol	REGISTER_A						
yfold	REGISTER_B						
yiin	UNKNOWN						
yk	REGISTER_A						
yk	REGISTER_B						
ykaiil	REGISTER_A						
ykaiir	REGISTER_B						
ykaip	REGISTER_B						
ykair	REGISTER_A						
ykair	REGISTER_B						
ykal	REGISTER_B						
ykald	REGISTER_A						
ykalk	REGISTER_B						
ykalo	REGISTER_A						
ykan	REGISTER_B						
ykar	REGISTER_A						
ykar	REGISTER_B						
ykaras	REGISTER_A						
ykaro	REGISTER_B						
ykarsh	REGISTER_A						
ykch	REGISTER_A						
ykch	REGISTER_B						
ykchd	REGISTER_A						
ykchd	REGISTER_B						
ykchdg	REGISTER_A						
ykche	REGISTER_A						
ykche	REGISTER_B						
ykched	REGISTER_B						
ykcho	REGISTER_A						
ykcho	REGISTER_B						
ykcholqod	REGISTER_A						
ykchom	REGISTER_A						
ykchon	REGISTER_A						
ykchos	REGISTER_B						
ykchs	REGISTER_B						
ykchscheg	REGISTER_B						
ykchys	REGISTER_B						
ykcsed	REGISTER_A						
ykdair	REGISTER_B						
yke	REGISTER_A						
yke	REGISTER_B						
ykecho	REGISTER_A						
yked	REGISTER_A						
yked	REGISTER_B						
ykeda	REGISTER_A						
ykee	REGISTER_A						
ykee	REGISTER_B						
ykeealke	REGISTER_B						
ykeear	REGISTER_B						
ykeech	REGISTER_A						
ykeed	REGISTER_A						
ykeed	REGISTER_B						
ykeee	REGISTER_B						
ykeeed	REGISTER_B						
ykeeeedaiir	REGISTER_A						
ykeeeos	REGISTER_B						
ykeeo	REGISTER_B						
ykeeod	REGISTER_A						
ykeeod	REGISTER_B						
ykeeode	REGISTER_B						
ykeeols	REGISTER_A						
ykeeos	REGISTER_B						
ykees	REGISTER_A						
ykees	REGISTER_B						
ykeesan	REGISTER_B						
ykeesh	REGISTER_B						
ykeeykee	REGISTER_A						
ykem	REGISTER_A						
ykeod	REGISTER_A						
ykeod	REGISTER_B						
ykeoda	REGISTER_A						
ykeoees	REGISTER_A						
ykeold	REGISTER_A						
ykeols	REGISTER_A						
ykeols	REGISTER_B						
ykeos	REGISTER_A						
ykeos	REGISTER_B						
ykeoshe	REGISTER_B						
ykes	REGISTER_A						
ykesh	REGISTER_B						
ykesheo	REGISTER_B						
ykesodarar	UNKNOWN						
ykeydom	REGISTER_B						
ykh	REGISTER_A						
ykh	REGISTER_B						
ykhe	REGISTER_A						
ykhe	REGISTER_B						
yko	REGISTER_A						
yko	REGISTER_B						
ykodas	REGISTER_B						
ykoear	REGISTER_B						
ykofar	REGISTER_A						
ykoiin	REGISTER_A						
ykol	REGISTER_A						
ykol	REGISTER_B						
ykold	REGISTER_A						
ykold	REGISTER_B						
ykooar	REGISTER_B						
ykor	REGISTER_B						
yksh	REGISTER_A						
ykshe	REGISTER_B						
ykshee	REGISTER_A						
ykych	REGISTER_A						
ykyk	REGISTER_A						
yl	REGISTER_B						
ylal	REGISTER_B						
ylar	REGISTER_B						
ylchd	REGISTER_B						
ylched	REGISTER_B						
ylcho	REGISTER_B						
ylg	REGISTER_A						
ylk	REGISTER_B						
ylshe	REGISTER_B						
yoched	REGISTER_B						
yod	REGISTER_B						
yoetee	REGISTER_B						
yok	REGISTER_B						
yols	REGISTER_B						
yolshee	REGISTER_B						
yom	REGISTER_B						
yoto	REGISTER_B						
yp	REGISTER_B						
ypaim	REGISTER_A						
ypair	REGISTER_B						
ypar	REGISTER_A						
ypar	REGISTER_B						
ypch	REGISTER_A						
ypch	REGISTER_B						
ypchar	REGISTER_A						
ypchd	REGISTER_B						
ypchdar	REGISTER_B						
ypche	REGISTER_A						
ypche	REGISTER_B						
ypched	REGISTER_A						
ypched	REGISTER_B						
ypched	UNKNOWN						
ypchedd	REGISTER_B						
ypcheed	REGISTER_B						
ypcheee	REGISTER_B						
ypcheg	REGISTER_B						
ypcher	REGISTER_B						
ypchocf	REGISTER_A						
ypchocpheos	REGISTER_A						
ypd	REGISTER_B						
ypod	REGISTER_A						
ypod	REGISTER_B						
ypshar	REGISTER_B						
ypshe	REGISTER_B						
ypshol	REGISTER_A						
yq	REGISTER_A						
yqokal	REGISTER_B						
yqopch	REGISTER_B						
yr	REGISTER_A						
yr	REGISTER_B						
yrche	REGISTER_B						
yrshe	REGISTER_B						
ys	REGISTER_A						
ys	REGISTER_B						
ysarasod	REGISTER_A						
yshche	REGISTER_A						
yshd	REGISTER_B						
yshe	REGISTER_B						
yshed	REGISTER_A						
yshee	REGISTER_B						
ysheed	REGISTER_B						
yt	REGISTER_A						
yt	REGISTER_B						
yt	UNKNOWN						
ytaiim	REGISTER_B						
ytaiir	REGISTER_A						
ytaim	REGISTER_B						
ytaipom	REGISTER_B						
ytair	REGISTER_A						
ytair	REGISTER_B						
ytal	REGISTER_A						
ytal	REGISTER_B						
ytalar	REGISTER_B						
ytalchos	REGISTER_B						
ytap	REGISTER_B						
ytar	REGISTER_A						
ytar	REGISTER_B						
ytarar	REGISTER_B						
ytash	REGISTER_B						
ytch	REGISTER_A						
ytch	REGISTER_B						
ytchal	REGISTER_B						
ytchcsee	REGISTER_B						
ytchd	REGISTER_A						
ytchd	REGISTER_B						
ytche	REGISTER_A						
ytche	REGISTER_B						
ytched	REGISTER_B						
ytcheodar	REGISTER_B						
ytcho	REGISTER_A						
ytchok	REGISTER_A						
ytdar	REGISTER_B						
ytdg	REGISTER_A						
yte	REGISTER_A						
yte	REGISTER_B						
yte	UNKNOWN						
ytech	REGISTER_B						
yted	REGISTER_A						
yted	REGISTER_B						
yted	UNKNOWN						
ytedar	REGISTER_B						
ytee	REGISTER_A						
ytee	REGISTER_B						
yteechypch	REGISTER_B						
yteed	REGISTER_A						
yteed	REGISTER_B						
yteee	REGISTER_B						
yteeed	REGISTER_B						
yteeo	REGISTER_A						
yteeoe	REGISTER_A						
yteeold	REGISTER_A						
ytees	REGISTER_B						
yteoch	REGISTER_B						
yteod	REGISTER_A						
yteod	REGISTER_B						
yteokar	REGISTER_B						
yteos	REGISTER_A						
yteos	REGISTER_B						
yto	REGISTER_A						
yto	REGISTER_B						
ytod	REGISTER_A						
ytod	REGISTER_B						
ytoiiin	REGISTER_A						
ytoiin	REGISTER_A						
ytoiin	REGISTER_B						
ytol	REGISTER_B						
ytolaiir	REGISTER_A						
ytold	REGISTER_A						
ytolk	REGISTER_B						
ytor	REGISTER_A						
ytoryd	REGISTER_A						
ytsh	REGISTER_A						
ytsh	REGISTER_B						
ytshed	REGISTER_B						
ytyd	REGISTER_A						
ytyda	REGISTER_A						
